IDX,ID,Anho,Mes,Descripcion,Total,Total_Previo,Total_Acumulado
0,200401,2004,1,Astorga,58,232,290
1,200401,2004,1,Cebreiro,240,494,734
2,200401,2004,1,León,46,152,198
3,200401,2004,1,Madrid - V.P.,34,0,34
4,200401,2004,1,Pamplona,30,122,152
5,200401,2004,1,Ponferrada,98,290,388
6,200401,2004,1,Resto,248,0,248
7,200401,2004,1,Roncesvalles,62,60,122
8,200401,2004,1,S. Jean P. Port,60,0,60
9,200401,2004,1,Sarria,304,734,1038
10,200401,2004,1,Vilafranca,106,388,494
11,200402,2004,2,Astorga,68,362,430
12,200402,2004,2,Cebreiro,334,588,922
13,200402,2004,2,Ferrol,68,0,68
14,200402,2004,2,León,116,246,362
15,200402,2004,2,Ponferrada,100,430,530
16,200402,2004,2,Resto,552,0,552
17,200402,2004,2,Roncesvalles,166,80,246
18,200402,2004,2,S. Jean P. Port,80,0,80
19,200402,2004,2,Sarria,1026,922,1948
20,200402,2004,2,Tui,234,0,234
21,200402,2004,2,Vilafranca,58,530,588
22,200403,2004,3,Astorga,254,864,1118
23,200403,2004,3,Cebreiro,1152,1536,2688
24,200403,2004,3,Ferrol,184,0,184
25,200403,2004,3,León,308,556,864
26,200403,2004,3,Ponferrada,290,1118,1408
27,200403,2004,3,Resto,1204,0,1204
28,200403,2004,3,Roncesvalles,436,120,556
29,200403,2004,3,S. Jean P. Port,120,0,120
30,200403,2004,3,Sarria,1484,2688,4172
31,200403,2004,3,Tui,650,0,650
32,200403,2004,3,Vilafranca,128,1408,1536
33,200404,2004,4,Astorga,1018,3560,4578
34,200404,2004,4,Cebreiro,4724,7164,11888
35,200404,2004,4,León,1210,2350,3560
36,200404,2004,4,Ourense,928,0,928
37,200404,2004,4,Ponferrada,1514,4578,6092
38,200404,2004,4,Resto,5666,0,5666
39,200404,2004,4,Roncesvalles,1566,784,2350
40,200404,2004,4,S. Jean P. Port,784,0,784
41,200404,2004,4,Sarria,9702,11888,21590
42,200404,2004,4,Tui,2924,0,2924
43,200404,2004,4,Vilafranca,1072,6092,7164
44,200405,2004,5,Astorga,1146,9608,10754
45,200405,2004,5,Burgos,830,6738,7568
46,200405,2004,5,Cebreiro,4080,12372,16452
47,200405,2004,5,León,2040,7568,9608
48,200405,2004,5,Pamplona,920,5818,6738
49,200405,2004,5,Ponferrada,1618,10754,12372
50,200405,2004,5,Resto,9454,0,9454
51,200405,2004,5,Roncesvalles,3096,2722,5818
52,200405,2004,5,S. Jean P. Port,2722,0,2722
53,200405,2004,5,Sarria,5658,16452,22110
54,200405,2004,5,Tui,2156,0,2156
55,200406,2004,6,Astorga,1462,10062,11524
56,200406,2004,6,Cebreiro,4932,14176,19108
57,200406,2004,6,León,1822,8240,10062
58,200406,2004,6,Pamplona,966,7274,8240
59,200406,2004,6,Ponferrada,1804,11524,13328
60,200406,2004,6,Resto,11516,0,11516
61,200406,2004,6,Roncesvalles,3896,3378,7274
62,200406,2004,6,S. Jean P. Port,3378,0,3378
63,200406,2004,6,Sarria,6628,19108,25736
64,200406,2004,6,Tui,1338,0,1338
65,200406,2004,6,Vilafranca,848,13328,14176
66,200407,2004,7,Astorga,3476,10218,13694
67,200407,2004,7,Cebreiro,7370,21278,28648
68,200407,2004,7,León,3634,6584,10218
69,200407,2004,7,Ponferrada,5336,13694,19030
70,200407,2004,7,Resto,17344,0,17344
71,200407,2004,7,Roncesvalles,4054,2530,6584
72,200407,2004,7,S. Jean P. Port,2530,0,2530
73,200407,2004,7,Sarria,12542,29716,42258
74,200407,2004,7,Triacastela,1068,28648,29716
75,200407,2004,7,Tui,4180,0,4180
76,200407,2004,7,Vilafranca,2248,19030,21278
77,200408,2004,8,Astorga,3120,13944,17064
78,200408,2004,8,Cebreiro,8028,22754,30782
79,200408,2004,8,León,4698,9246,13944
80,200408,2004,8,Ourense,6358,0,6358
81,200408,2004,8,Oviedo - C.P.,5290,0,5290
82,200408,2004,8,Ponferrada,5690,17064,22754
83,200408,2004,8,Resto,24802,0,24802
84,200408,2004,8,Roncesvalles,5960,3286,9246
85,200408,2004,8,S. Jean P. Port,3286,0,3286
86,200408,2004,8,Sarria,18940,30782,49722
87,200408,2004,8,Tui,5030,0,5030
88,200409,2004,9,Astorga,1954,9972,11926
89,200409,2004,9,Cebreiro,4630,15946,20576
90,200409,2004,9,León,2722,7250,9972
91,200409,2004,9,Pamplona,1102,6148,7250
92,200409,2004,9,Ponferrada,2924,11926,14850
93,200409,2004,9,Resto,11290,0,11290
94,200409,2004,9,Roncesvalles,3572,2576,6148
95,200409,2004,9,S. Jean P. Port,2576,0,2576
96,200409,2004,9,Sarria,11576,20576,32152
97,200409,2004,9,Tui,2062,0,2062
98,200409,2004,9,Vilafranca,1096,14850,15946
99,200410,2004,10,Astorga,950,6868,7818
100,200410,2004,10,Cebreiro,2894,9188,12082
101,200410,2004,10,Le Puy,672,0,672
102,200410,2004,10,León,1404,5464,6868
103,200410,2004,10,Ourense,816,0,816
104,200410,2004,10,Ponferrada,1370,7818,9188
105,200410,2004,10,Resto,7152,0,7152
106,200410,2004,10,Roncesvalles,2398,3066,5464
107,200410,2004,10,S. Jean P. Port,2394,672,3066
108,200410,2004,10,Sarria,7692,12082,19774
109,200410,2004,10,Tui,1370,0,1370
110,200411,2004,11,Astorga,244,1686,1930
111,200411,2004,11,Cebreiro,1532,2248,3780
112,200411,2004,11,Le Puy,196,0,196
113,200411,2004,11,León,302,1384,1686
114,200411,2004,11,Ponferrada,318,1930,2248
115,200411,2004,11,Resto,2432,0,2432
116,200411,2004,11,Roncesvalles,646,738,1384
117,200411,2004,11,S. Jean P. Port,542,196,738
118,200411,2004,11,Sarria,1966,3926,5892
119,200411,2004,11,Triacastela,146,3780,3926
120,200411,2004,11,Tui,496,0,496
121,200412,2004,12,Astorga,128,828,956
122,200412,2004,12,Cebreiro,1474,1178,2652
123,200412,2004,12,Ferrol,144,0,144
124,200412,2004,12,León,258,570,828
125,200412,2004,12,Oviedo - C.P.,144,0,144
126,200412,2004,12,Ponferrada,222,956,1178
127,200412,2004,12,Resto,1718,0,1718
128,200412,2004,12,Roncesvalles,362,208,570
129,200412,2004,12,S. Jean P. Port,208,0,208
130,200412,2004,12,Sarria,1964,2652,4616
131,200412,2004,12,Tui,982,0,982
132,200501,2005,1,Astorga,18,156,174
133,200501,2005,1,Burgos,18,82,100
134,200501,2005,1,Cebreiro,66,202,268
135,200501,2005,1,León,56,100,156
136,200501,2005,1,Pamplona,16,66,82
137,200501,2005,1,Ponferrada,28,174,202
138,200501,2005,1,Resto,160,0,160
139,200501,2005,1,Roncesvalles,22,44,66
140,200501,2005,1,S. Jean P. Port,44,0,44
141,200501,2005,1,Sarria,84,268,352
142,200501,2005,1,Tui,26,0,26
143,200502,2005,2,Braga,24,0,24
144,200502,2005,2,Burgos,36,106,142
145,200502,2005,2,Cebreiro,462,242,704
146,200502,2005,2,León,46,142,188
147,200502,2005,2,Pamplona,20,86,106
148,200502,2005,2,Ponferrada,54,188,242
149,200502,2005,2,Resto,180,0,180
150,200502,2005,2,Roncesvalles,42,44,86
151,200502,2005,2,S. Jean P. Port,44,0,44
152,200502,2005,2,Sarria,162,704,866
153,200502,2005,2,Tui,60,0,60
154,200503,2005,3,Astorga,278,598,876
155,200503,2005,3,Cebreiro,790,1356,2146
156,200503,2005,3,León,256,342,598
157,200503,2005,3,Lugo - C.P.,138,0,138
158,200503,2005,3,Ponferrada,296,876,1172
159,200503,2005,3,Resto,1492,0,1492
160,200503,2005,3,Roncesvalles,342,0,342
161,200503,2005,3,Sarria,2004,2146,4150
162,200503,2005,3,Tui,266,196,462
163,200503,2005,3,Valença do Minho,196,0,196
164,200503,2005,3,Vilafranca,184,1172,1356
165,200504,2005,4,Astorga,284,1462,1746
166,200504,2005,4,Cebreiro,510,2342,2852
167,200504,2005,4,León,458,1004,1462
168,200504,2005,4,Ponferrada,380,1746,2126
169,200504,2005,4,Resto,1956,0,1956
170,200504,2005,4,Roncesvalles,530,474,1004
171,200504,2005,4,S. Jean P. Port,474,0,474
172,200504,2005,4,Sarria,1212,2852,4064
173,200504,2005,4,Tui,292,302,594
174,200504,2005,4,Valença do Minho,302,0,302
175,200504,2005,4,Vilafranca,216,2126,2342
176,200505,2005,5,Astorga,622,8042,8664
177,200505,2005,5,Burgos,622,6064,6686
178,200505,2005,5,Cebreiro,1168,9690,10858
179,200505,2005,5,Le Puy,676,0,676
180,200505,2005,5,León,1356,6686,8042
181,200505,2005,5,Pamplona,1026,5038,6064
182,200505,2005,5,Ponferrada,1026,8664,9690
183,200505,2005,5,Resto,5664,0,5664
184,200505,2005,5,Roncesvalles,1694,3344,5038
185,200505,2005,5,S. Jean P. Port,2668,676,3344
186,200505,2005,5,Sarria,2098,10858,12956
187,200506,2005,6,Astorga,972,11668,12640
188,200506,2005,6,Cebreiro,1224,13796,15020
189,200506,2005,6,Francia - C.F.,788,0,788
190,200506,2005,6,Le Puy,1044,0,1044
191,200506,2005,6,León,1768,9900,11668
192,200506,2005,6,Pamplona,1266,8634,9900
193,200506,2005,6,Ponferrada,1156,12640,13796
194,200506,2005,6,Resto,7542,0,7542
195,200506,2005,6,Roncesvalles,2998,5636,8634
196,200506,2005,6,S. Jean P. Port,3804,1832,5636
197,200506,2005,6,Sarria,2676,15020,17696
198,200507,2005,7,Astorga,2482,10388,12870
199,200507,2005,7,Burgos,954,6882,7836
200,200507,2005,7,Cebreiro,3274,15588,18862
201,200507,2005,7,León,2552,7836,10388
202,200507,2005,7,Pamplona,1028,5854,6882
203,200507,2005,7,Ponferrada,2718,12870,15588
204,200507,2005,7,Resto,10976,0,10976
205,200507,2005,7,Roncesvalles,3128,2726,5854
206,200507,2005,7,S. Jean P. Port,2726,0,2726
207,200507,2005,7,Sarria,6674,18862,25536
208,200507,2005,7,Tui,1096,0,1096
209,200508,2005,8,Astorga,2288,14470,16758
210,200508,2005,8,Burgos,1396,9480,10876
211,200508,2005,8,Cebreiro,4244,22102,26346
212,200508,2005,8,León,3594,10876,14470
213,200508,2005,8,Ponferrada,3856,16758,20614
214,200508,2005,8,Resto,12820,0,12820
215,200508,2005,8,Roncesvalles,5412,4068,9480
216,200508,2005,8,S. Jean P. Port,4068,0,4068
217,200508,2005,8,Sarria,8858,26346,35204
218,200508,2005,8,Tui,1638,0,1638
219,200508,2005,8,Vilafranca,1488,20614,22102
220,200509,2005,9,Astorga,1164,9542,10706
221,200509,2005,9,Burgos,776,6674,7450
222,200509,2005,9,Cebreiro,2238,12220,14458
223,200509,2005,9,Le Puy,656,0,656
224,200509,2005,9,León,2092,7450,9542
225,200509,2005,9,Pamplona,912,5762,6674
226,200509,2005,9,Ponferrada,1514,10706,12220
227,200509,2005,9,Resto,6232,0,6232
228,200509,2005,9,Roncesvalles,2380,3382,5762
229,200509,2005,9,S. Jean P. Port,2726,656,3382
230,200509,2005,9,Sarria,3646,14458,18104
231,200510,2005,10,Astorga,378,6456,6834
232,200510,2005,10,Cebreiro,646,7636,8282
233,200510,2005,10,Francia - C.F.,406,0,406
234,200510,2005,10,Le Puy,626,0,626
235,200510,2005,10,León,976,5480,6456
236,200510,2005,10,Pamplona,568,4912,5480
237,200510,2005,10,Ponferrada,802,6834,7636
238,200510,2005,10,Resto,3598,0,3598
239,200510,2005,10,Roncesvalles,1494,3418,4912
240,200510,2005,10,S. Jean P. Port,2386,1032,3418
241,200510,2005,10,Sarria,1866,8282,10148
242,200511,2005,11,Astorga,86,1400,1486
243,200511,2005,11,Burgos,84,1188,1272
244,200511,2005,11,Cebreiro,154,1486,1640
245,200511,2005,11,Francia - C.F.,106,0,106
246,200511,2005,11,Le Puy,114,0,114
247,200511,2005,11,León,128,1272,1400
248,200511,2005,11,Pamplona,112,1076,1188
249,200511,2005,11,Resto,884,0,884
250,200511,2005,11,Roncesvalles,304,772,1076
251,200511,2005,11,S. Jean P. Port,552,220,772
252,200511,2005,11,Sarria,252,1640,1892
253,200512,2005,12,Cebreiro,98,350,448
254,200512,2005,12,Ferrol,78,0,78
255,200512,2005,12,Fonsagrada - C.P.,40,0,40
256,200512,2005,12,León,70,216,286
257,200512,2005,12,Ourense,40,0,40
258,200512,2005,12,Ponferrada,64,286,350
259,200512,2005,12,Resto,488,0,488
260,200512,2005,12,Roncesvalles,114,102,216
261,200512,2005,12,S. Jean P. Port,102,0,102
262,200512,2005,12,Sarria,188,448,636
263,200512,2005,12,Tui,54,0,54
264,200601,2006,1,Astorga,26,162,188
265,200601,2006,1,Burgos,26,86,112
266,200601,2006,1,Cebreiro,70,250,320
267,200601,2006,1,León,50,112,162
268,200601,2006,1,Ponferrada,34,188,222
269,200601,2006,1,Resto,204,0,204
270,200601,2006,1,Roncesvalles,58,28,86
271,200601,2006,1,S. Jean P. Port,28,0,28
272,200601,2006,1,Sarria,102,320,422
273,200601,2006,1,Valença do Minho,22,0,22
274,200601,2006,1,Vilafranca,28,222,250
275,200602,2006,2,Astorga,32,126,158
276,200602,2006,2,Burgos,20,82,102
277,200602,2006,2,Cebreiro,88,186,274
278,200602,2006,2,León,24,102,126
279,200602,2006,2,Ponferrada,28,158,186
280,200602,2006,2,Resto,158,0,158
281,200602,2006,2,Roncesvalles,54,28,82
282,200602,2006,2,S. Jean P. Port,28,0,28
283,200602,2006,2,Samos,18,0,18
284,200602,2006,2,Sarria,220,292,512
285,200602,2006,2,Valença do Minho,32,0,32
286,200603,2006,3,Astorga,72,488,560
287,200603,2006,3,Cebreiro,218,730,948
288,200603,2006,3,León,196,292,488
289,200603,2006,3,Pamplona,60,232,292
290,200603,2006,3,Ponferrada,100,560,660
291,200603,2006,3,Resto,572,0,572
292,200603,2006,3,Roncesvalles,112,120,232
293,200603,2006,3,S. Jean P. Port,120,0,120
294,200603,2006,3,Sarria,596,1024,1620
295,200603,2006,3,Triacastela,76,948,1024
296,200603,2006,3,Vilafranca,70,660,730
297,200604,2006,4,Astorga,432,2202,2634
298,200604,2006,4,Cebreiro,1158,3590,4748
299,200604,2006,4,León,698,1504,2202
300,200604,2006,4,Oporto,402,0,402
301,200604,2006,4,Ponferrada,956,2634,3590
302,200604,2006,4,Resto,4426,0,4426
303,200604,2006,4,Roncesvalles,858,646,1504
304,200604,2006,4,S. Jean P. Port,646,0,646
305,200604,2006,4,Sarria,4116,4748,8864
306,200604,2006,4,Tui,714,898,1612
307,200604,2006,4,Valença do Minho,496,402,898
308,200605,2006,5,Astorga,880,8818,9698
309,200605,2006,5,Burgos,706,6718,7424
310,200605,2006,5,Cebreiro,1032,10576,11608
311,200605,2006,5,Le Puy,914,0,914
312,200605,2006,5,León,1394,7424,8818
313,200605,2006,5,Pamplona,930,5788,6718
314,200605,2006,5,Ponferrada,878,9698,10576
315,200605,2006,5,Resto,6212,0,6212
316,200605,2006,5,Roncesvalles,1722,4066,5788
317,200605,2006,5,S. Jean P. Port,3152,914,4066
318,200605,2006,5,Sarria,2474,11608,14082
319,200606,2006,6,Astorga,926,12032,12958
320,200606,2006,6,Cebreiro,1334,14044,15378
321,200606,2006,6,Francia - C.F.,786,0,786
322,200606,2006,6,Le Puy,1156,0,1156
323,200606,2006,6,León,1748,10284,12032
324,200606,2006,6,Pamplona,1258,9026,10284
325,200606,2006,6,Ponferrada,1086,12958,14044
326,200606,2006,6,Resto,7896,0,7896
327,200606,2006,6,Roncesvalles,2822,6204,9026
328,200606,2006,6,S. Jean P. Port,4262,1942,6204
329,200606,2006,6,Sarria,2748,15378,18126
330,200607,2006,7,Astorga,2052,9330,11382
331,200607,2006,7,Burgos,872,5884,6756
332,200607,2006,7,Cebreiro,2674,14738,17412
333,200607,2006,7,León,2574,6756,9330
334,200607,2006,7,Ponferrada,2332,11382,13714
335,200607,2006,7,Resto,12888,0,12888
336,200607,2006,7,Roncesvalles,3146,2738,5884
337,200607,2006,7,S. Jean P. Port,2738,0,2738
338,200607,2006,7,Sarria,6140,17412,23552
339,200607,2006,7,Tui,1000,0,1000
340,200607,2006,7,Vilafranca,1024,13714,14738
341,200608,2006,8,Astorga,2170,16598,18768
342,200608,2006,8,Burgos,1446,11154,12600
343,200608,2006,8,Cebreiro,3970,23834,27804
344,200608,2006,8,León,3998,12600,16598
345,200608,2006,8,Pamplona,1450,9704,11154
346,200608,2006,8,Ponferrada,3762,18768,22530
347,200608,2006,8,Resto,15104,0,15104
348,200608,2006,8,Roncesvalles,5442,4262,9704
349,200608,2006,8,S. Jean P. Port,4262,0,4262
350,200608,2006,8,Sarria,9458,27804,37262
351,200608,2006,8,Vilafranca,1304,22530,23834
352,200609,2006,9,Astorga,1262,10674,11936
353,200609,2006,9,Burgos,1040,7550,8590
354,200609,2006,9,Cebreiro,1642,13590,15232
355,200609,2006,9,Le Puy,928,0,928
356,200609,2006,9,León,2084,8590,10674
357,200609,2006,9,Pamplona,1080,6470,7550
358,200609,2006,9,Ponferrada,1654,11936,13590
359,200609,2006,9,Resto,7652,0,7652
360,200609,2006,9,Roncesvalles,2418,4052,6470
361,200609,2006,9,S. Jean P. Port,3124,928,4052
362,200609,2006,9,Sarria,4056,15232,19288
363,200610,2006,10,Astorga,498,7120,7618
364,200610,2006,10,Cebreiro,716,8294,9010
365,200610,2006,10,Francia - C.F.,438,0,438
366,200610,2006,10,Le Puy,788,0,788
367,200610,2006,10,León,928,6192,7120
368,200610,2006,10,Pamplona,660,5532,6192
369,200610,2006,10,Ponferrada,676,7618,8294
370,200610,2006,10,Resto,4230,0,4230
371,200610,2006,10,Roncesvalles,1504,4028,5532
372,200610,2006,10,S. Jean P. Port,2802,1226,4028
373,200610,2006,10,Sarria,2160,9010,11170
374,200611,2006,11,Cebreiro,206,1692,1898
375,200611,2006,11,Le Puy,210,0,210
376,200611,2006,11,León,146,1370,1516
377,200611,2006,11,Pamplona,144,1120,1264
378,200611,2006,11,Ponferrada,176,1516,1692
379,200611,2006,11,Resto,1148,0,1148
380,200611,2006,11,Ribadeo,110,0,110
381,200611,2006,11,Roncesvalles,342,778,1120
382,200611,2006,11,S. Jean P. Port,568,210,778
383,200611,2006,11,Sarria,354,1898,2252
384,200611,2006,11,Somport,106,0,106
385,200612,2006,12,Astorga,52,496,548
386,200612,2006,12,Cebreiro,166,680,846
387,200612,2006,12,Le Puy,44,0,44
388,200612,2006,12,León,62,434,496
389,200612,2006,12,Ponferrada,88,548,636
390,200612,2006,12,Resto,456,0,456
391,200612,2006,12,Roncesvalles,246,188,434
392,200612,2006,12,S. Jean P. Port,144,44,188
393,200612,2006,12,Sarria,276,846,1122
394,200612,2006,12,Tui,118,0,118
395,200612,2006,12,Vilafranca,44,636,680
396,200701,2007,1,Astorga,38,230,268
397,200701,2007,1,Cebreiro,50,324,374
398,200701,2007,1,León,52,178,230
399,200701,2007,1,Oviedo - C.P.,16,0,16
400,200701,2007,1,Pamplona,28,150,178
401,200701,2007,1,Ponferrada,56,268,324
402,200701,2007,1,Resto,170,0,170
403,200701,2007,1,Roncesvalles,70,80,150
404,200701,2007,1,S. Jean P. Port,80,0,80
405,200701,2007,1,Sarria,124,374,498
406,200701,2007,1,Tui,16,0,16
407,200702,2007,2,Cebreiro,234,254,488
408,200702,2007,2,León,88,108,196
409,200702,2007,2,Ponferrada,58,196,254
410,200702,2007,2,Resto,306,0,306
411,200702,2007,2,Roncesvalles,58,50,108
412,200702,2007,2,S. Jean P. Port,50,0,50
413,200702,2007,2,Sarria,284,570,854
414,200702,2007,2,Triacastela,82,488,570
415,200702,2007,2,Tui,60,54,114
416,200702,2007,2,Valença do Minho,54,0,54
417,200702,2007,2,Vilalba,56,0,56
418,200703,2007,3,Burgos,92,480,572
419,200703,2007,3,Cebreiro,412,972,1384
420,200703,2007,3,León,258,572,830
421,200703,2007,3,Pamplona,100,380,480
422,200703,2007,3,Ponferrada,142,830,972
423,200703,2007,3,Resto,990,0,990
424,200703,2007,3,Roncesvalles,180,200,380
425,200703,2007,3,S. Jean P. Port,200,0,200
426,200703,2007,3,Samos,90,0,90
427,200703,2007,3,Sarria,720,1650,2370
428,200703,2007,3,Triacastela,176,1384,1560
429,200704,2007,4,Astorga,516,4046,4562
430,200704,2007,4,Cebreiro,1096,5346,6442
431,200704,2007,4,Le Puy,472,0,472
432,200704,2007,4,León,1022,3024,4046
433,200704,2007,4,Pamplona,458,2566,3024
434,200704,2007,4,Ponferrada,784,4562,5346
435,200704,2007,4,Resto,5454,0,5454
436,200704,2007,4,Roncesvalles,918,1648,2566
437,200704,2007,4,S. Jean P. Port,1176,472,1648
438,200704,2007,4,Sarria,3690,6442,10132
439,200704,2007,4,Tui,644,0,644
440,200705,2007,5,Astorga,980,11316,12296
441,200705,2007,5,Burgos,800,8664,9464
442,200705,2007,5,Cebreiro,1370,13178,14548
443,200705,2007,5,Le Puy,1152,0,1152
444,200705,2007,5,León,1852,9464,11316
445,200705,2007,5,Pamplona,1372,7292,8664
446,200705,2007,5,Ponferrada,882,12296,13178
447,200705,2007,5,Resto,7908,0,7908
448,200705,2007,5,Roncesvalles,2020,5272,7292
449,200705,2007,5,S. Jean P. Port,4120,1152,5272
450,200705,2007,5,Sarria,3392,14548,17940
451,200706,2007,6,Astorga,1026,13570,14596
452,200706,2007,6,Burgos,888,10684,11572
453,200706,2007,6,Cebreiro,1552,15784,17336
454,200706,2007,6,Le Puy,1122,0,1122
455,200706,2007,6,León,1998,11572,13570
456,200706,2007,6,Pamplona,1408,9276,10684
457,200706,2007,6,Ponferrada,1188,14596,15784
458,200706,2007,6,Resto,9314,0,9314
459,200706,2007,6,Roncesvalles,2670,6606,9276
460,200706,2007,6,S. Jean P. Port,5484,1122,6606
461,200706,2007,6,Sarria,3714,17336,21050
462,200707,2007,7,Astorga,2204,11000,13204
463,200707,2007,7,Burgos,1078,7452,8530
464,200707,2007,7,Cebreiro,2698,15712,18410
465,200707,2007,7,León,2470,8530,11000
466,200707,2007,7,Pamplona,990,6462,7452
467,200707,2007,7,Ponferrada,2508,13204,15712
468,200707,2007,7,Resto,14146,0,14146
469,200707,2007,7,Roncesvalles,2822,3640,6462
470,200707,2007,7,S. Jean P. Port,3640,0,3640
471,200707,2007,7,Sarria,6412,18410,24822
472,200707,2007,7,Tui,1344,0,1344
473,200708,2007,8,Astorga,1930,16596,18526
474,200708,2007,8,Burgos,1258,11332,12590
475,200708,2007,8,Cebreiro,4010,22262,26272
476,200708,2007,8,León,4006,12590,16596
477,200708,2007,8,Pamplona,1468,9864,11332
478,200708,2007,8,Ponferrada,3736,18526,22262
479,200708,2007,8,Resto,15986,0,15986
480,200708,2007,8,Roncesvalles,4898,4966,9864
481,200708,2007,8,S. Jean P. Port,4966,0,4966
482,200708,2007,8,Sarria,10668,26272,36940
483,200708,2007,8,Tui,1652,0,1652
484,200709,2007,9,Astorga,1402,11200,12602
485,200709,2007,9,Burgos,822,8118,8940
486,200709,2007,9,Cebreiro,1924,14374,16298
487,200709,2007,9,Le Puy,876,0,876
488,200709,2007,9,León,2260,8940,11200
489,200709,2007,9,Pamplona,1062,7056,8118
490,200709,2007,9,Ponferrada,1772,12602,14374
491,200709,2007,9,Resto,9080,0,9080
492,200709,2007,9,Roncesvalles,2308,4748,7056
493,200709,2007,9,S. Jean P. Port,3872,876,4748
494,200709,2007,9,Sarria,5186,16298,21484
495,200710,2007,10,Astorga,362,4129,4491
496,200710,2007,10,Cebreiro,513,4884,5397
497,200710,2007,10,Francia - C.F.,229,0,229
498,200710,2007,10,Le Puy,393,0,393
499,200710,2007,10,León,589,3540,4129
500,200710,2007,10,Pamplona,342,3198,3540
501,200710,2007,10,Ponferrada,393,4491,4884
502,200710,2007,10,Resto,2688,0,2688
503,200710,2007,10,Roncesvalles,772,2426,3198
504,200710,2007,10,S. Jean P. Port,1804,622,2426
505,200710,2007,10,Sarria,1358,5397,6755
506,200711,2007,11,Cebreiro,115,950,1065
507,200711,2007,11,Le Puy,92,0,92
508,200711,2007,11,León,87,774,861
509,200711,2007,11,Oporto,95,0,95
510,200711,2007,11,Oviedo - C.P.,73,0,73
511,200711,2007,11,Pamplona,77,697,774
512,200711,2007,11,Ponferrada,89,861,950
513,200711,2007,11,Resto,805,0,805
514,200711,2007,11,Roncesvalles,215,482,697
515,200711,2007,11,S. Jean P. Port,390,92,482
516,200711,2007,11,Sarria,458,1065,1523
517,200712,2007,12,Astorga,29,173,202
518,200712,2007,12,Cebreiro,92,253,345
519,200712,2007,12,León,34,139,173
520,200712,2007,12,Ponferrada,24,202,226
521,200712,2007,12,Resto,268,0,268
522,200712,2007,12,Ribadeo,30,0,30
523,200712,2007,12,Roncesvalles,62,77,139
524,200712,2007,12,S. Jean P. Port,77,0,77
525,200712,2007,12,Sarria,132,345,477
526,200712,2007,12,Tui,20,0,20
527,200712,2007,12,Vilafranca,27,226,253
528,200801,2008,1,Astorga,18,78,96
529,200801,2008,1,Burgos,12,48,60
530,200801,2008,1,Cebreiro,26,121,147
531,200801,2008,1,León,18,60,78
532,200801,2008,1,Oporto,11,0,11
533,200801,2008,1,Pamplona,10,38,48
534,200801,2008,1,Ponferrada,25,96,121
535,200801,2008,1,Resto,92,0,92
536,200801,2008,1,Roncesvalles,18,20,38
537,200801,2008,1,S. Jean P. Port,20,0,20
538,200801,2008,1,Sarria,56,147,203
539,200802,2008,2,Cebreiro,146,155,301
540,200802,2008,2,León,28,87,115
541,200802,2008,2,Ponferrada,25,115,140
542,200802,2008,2,Resto,163,0,163
543,200802,2008,2,Roncesvalles,37,50,87
544,200802,2008,2,S. Jean P. Port,50,0,50
545,200802,2008,2,Sarria,125,335,460
546,200802,2008,2,Triacastela,34,301,335
547,200802,2008,2,Tui,62,18,80
548,200802,2008,2,Valença do Minho,18,0,18
549,200802,2008,2,Vilafranca,15,140,155
550,200803,2008,3,Astorga,168,674,842
551,200803,2008,3,Cebreiro,460,1096,1556
552,200803,2008,3,León,194,480,674
553,200803,2008,3,Ourense,137,0,137
554,200803,2008,3,Ponferrada,254,842,1096
555,200803,2008,3,Resto,1688,0,1688
556,200803,2008,3,Roncesvalles,307,173,480
557,200803,2008,3,S. Jean P. Port,173,0,173
558,200803,2008,3,Sarria,1565,1556,3121
559,200803,2008,3,Tui,227,154,381
560,200803,2008,3,Valença do Minho,154,0,154
561,200804,2008,4,Astorga,182,1703,1885
562,200804,2008,4,Cebreiro,222,2097,2319
563,200804,2008,4,León,425,1117,1542
564,200804,2008,4,Oporto,283,0,283
565,200804,2008,4,Pamplona,218,899,1117
566,200804,2008,4,Ponferrada,212,1885,2097
567,200804,2008,4,Resto,1707,0,1707
568,200804,2008,4,Roncesvalles,342,557,899
569,200804,2008,4,S. Jean P. Port,557,0,557
570,200804,2008,4,Sarria,1339,2319,3658
571,200804,2008,4,Sevilla,161,0,161
572,200805,2008,5,Astorga,623,6130,6753
573,200805,2008,5,Cebreiro,669,7445,8114
574,200805,2008,5,Le Puy,506,0,506
575,200805,2008,5,León,1157,4973,6130
576,200805,2008,5,Oporto,557,0,557
577,200805,2008,5,Pamplona,747,4226,4973
578,200805,2008,5,Ponferrada,692,6753,7445
579,200805,2008,5,Resto,5174,0,5174
580,200805,2008,5,Roncesvalles,1080,3146,4226
581,200805,2008,5,S. Jean P. Port,2640,506,3146
582,200805,2008,5,Sarria,2156,8114,10270
583,200806,2008,6,Astorga,474,7416,7890
584,200806,2008,6,Burgos,435,5870,6305
585,200806,2008,6,Cebreiro,814,8477,9291
586,200806,2008,6,Le Puy,546,0,546
587,200806,2008,6,León,1111,6305,7416
588,200806,2008,6,Pamplona,794,5076,5870
589,200806,2008,6,Ponferrada,587,7890,8477
590,200806,2008,6,Resto,4767,0,4767
591,200806,2008,6,Roncesvalles,1451,3625,5076
592,200806,2008,6,S. Jean P. Port,3079,546,3625
593,200806,2008,6,Sarria,1846,9291,11137
594,200807,2008,7,Astorga,1187,5126,6313
595,200807,2008,7,Cebreiro,1296,8165,9461
596,200807,2008,7,León,1298,3828,5126
597,200807,2008,7,Pamplona,574,3254,3828
598,200807,2008,7,Ponferrada,1386,6313,7699
599,200807,2008,7,Resto,7215,0,7215
600,200807,2008,7,Roncesvalles,1261,1993,3254
601,200807,2008,7,S. Jean P. Port,1993,0,1993
602,200807,2008,7,Sarria,3676,9461,13137
603,200807,2008,7,Tui,714,0,714
604,200807,2008,7,Vilafranca,466,7699,8165
605,200808,2008,8,Astorga,1150,8635,9785
606,200808,2008,8,Burgos,708,5891,6599
607,200808,2008,8,Cebreiro,2492,11717,14209
608,200808,2008,8,León,2036,6599,8635
609,200808,2008,8,Pamplona,709,5182,5891
610,200808,2008,8,Ponferrada,1932,9785,11717
611,200808,2008,8,Resto,9149,0,9149
612,200808,2008,8,Roncesvalles,2427,2755,5182
613,200808,2008,8,S. Jean P. Port,2755,0,2755
614,200808,2008,8,Sarria,5490,14209,19699
615,200808,2008,8,Tui,1148,0,1148
616,200809,2008,9,Astorga,797,6498,7295
617,200809,2008,9,Burgos,518,4622,5140
618,200809,2008,9,Cebreiro,1114,8290,9404
619,200809,2008,9,Le Puy,471,0,471
620,200809,2008,9,León,1358,5140,6498
621,200809,2008,9,Pamplona,685,3937,4622
622,200809,2008,9,Ponferrada,995,7295,8290
623,200809,2008,9,Resto,5247,0,5247
624,200809,2008,9,Roncesvalles,1307,2630,3937
625,200809,2008,9,S. Jean P. Port,2159,471,2630
626,200809,2008,9,Sarria,2727,9404,12131
627,200810,2008,10,Astorga,389,4191,4580
628,200810,2008,10,Burgos,300,3375,3675
629,200810,2008,10,Cebreiro,435,5020,5455
630,200810,2008,10,Le Puy,380,0,380
631,200810,2008,10,León,516,3675,4191
632,200810,2008,10,Pamplona,401,2974,3375
633,200810,2008,10,Ponferrada,440,4580,5020
634,200810,2008,10,Resto,2968,0,2968
635,200810,2008,10,Roncesvalles,765,2209,2974
636,200810,2008,10,S. Jean P. Port,1829,380,2209
637,200810,2008,10,Sarria,1455,5455,6910
638,200811,2008,11,Astorga,56,853,909
639,200811,2008,11,Cebreiro,134,1009,1143
640,200811,2008,11,Le Puy,110,0,110
641,200811,2008,11,León,86,767,853
642,200811,2008,11,Oporto,62,0,62
643,200811,2008,11,Pamplona,60,707,767
644,200811,2008,11,Ponferrada,100,909,1009
645,200811,2008,11,Resto,763,0,763
646,200811,2008,11,Roncesvalles,170,537,707
647,200811,2008,11,S. Jean P. Port,427,110,537
648,200811,2008,11,Sarria,341,1143,1484
649,200812,2008,12,Cebreiro,101,225,326
650,200812,2008,12,León,30,167,197
651,200812,2008,12,Pamplona,28,139,167
652,200812,2008,12,Ponferrada,28,197,225
653,200812,2008,12,Resto,287,0,287
654,200812,2008,12,Resto Portugal,29,0,29
655,200812,2008,12,Roncesvalles,55,84,139
656,200812,2008,12,S. Jean P. Port,84,0,84
657,200812,2008,12,Sarria,152,326,478
658,200812,2008,12,Tui,98,29,127
659,200812,2008,12,Vigo,193,0,193
660,200901,2009,1,Burgos,14,118,132
661,200901,2009,1,Cebreiro,40,208,248
662,200901,2009,1,Estella,26,92,118
663,200901,2009,1,Fonsagrada - C.P.,14,0,14
664,200901,2009,1,León,49,132,181
665,200901,2009,1,Pamplona,19,73,92
666,200901,2009,1,Ponferrada,27,181,208
667,200901,2009,1,Resto,150,0,150
668,200901,2009,1,Roncesvalles,23,50,73
669,200901,2009,1,S. Jean P. Port,50,0,50
670,200901,2009,1,Sarria,111,248,359
671,200902,2009,2,Astorga,26,103,129
672,200902,2009,2,Cebreiro,144,129,273
673,200902,2009,2,León,34,69,103
674,200902,2009,2,Oporto,18,0,18
675,200902,2009,2,Resto,223,0,223
676,200902,2009,2,Roncesvalles,41,28,69
677,200902,2009,2,S. Jean P. Port,28,0,28
678,200902,2009,2,Sarria,106,294,400
679,200902,2009,2,Triacastela,21,273,294
680,200902,2009,2,Tui,36,39,75
681,200902,2009,2,Valença do Minho,21,18,39
682,200903,2009,3,Astorga,77,549,626
683,200903,2009,3,Cebreiro,96,712,808
684,200903,2009,3,León,160,330,490
685,200903,2009,3,Pamplona,65,265,330
686,200903,2009,3,Ponferrada,86,626,712
687,200903,2009,3,Resto,591,0,591
688,200903,2009,3,Roncesvalles,141,124,265
689,200903,2009,3,S. Jean P. Port,124,0,124
690,200903,2009,3,Sarria,396,808,1204
691,200903,2009,3,Sevilla,59,0,59
692,200903,2009,3,Tui,55,0,55
693,200904,2009,4,Astorga,307,1986,2293
694,200904,2009,4,Burgos,220,1222,1442
695,200904,2009,4,Cebreiro,831,2776,3607
696,200904,2009,4,León,544,1442,1986
697,200904,2009,4,Ponferrada,483,2293,2776
698,200904,2009,4,Resto,3241,0,3241
699,200904,2009,4,Roncesvalles,577,645,1222
700,200904,2009,4,S. Jean P. Port,645,0,645
701,200904,2009,4,Sarria,2742,3607,6349
702,200904,2009,4,Tui,469,257,726
703,200904,2009,4,Valença do Minho,257,0,257
704,200905,2009,5,Astorga,545,5784,6329
705,200905,2009,5,Cebreiro,768,7034,7802
706,200905,2009,5,Le Puy,509,0,509
707,200905,2009,5,León,1089,4695,5784
708,200905,2009,5,Oporto,677,0,677
709,200905,2009,5,Pamplona,710,3985,4695
710,200905,2009,5,Ponferrada,705,6329,7034
711,200905,2009,5,Resto,5708,0,5708
712,200905,2009,5,Roncesvalles,1164,2821,3985
713,200905,2009,5,S. Jean P. Port,2312,509,2821
714,200905,2009,5,Sarria,2311,7802,10113
715,200906,2009,6,Astorga,624,7811,8435
716,200906,2009,6,Burgos,567,5926,6493
717,200906,2009,6,Cebreiro,977,9341,10318
718,200906,2009,6,Le Puy,618,0,618
719,200906,2009,6,León,1318,6493,7811
720,200906,2009,6,Pamplona,726,5200,5926
721,200906,2009,6,Ponferrada,906,8435,9341
722,200906,2009,6,Resto,6582,0,6582
723,200906,2009,6,Roncesvalles,1536,3664,5200
724,200906,2009,6,S. Jean P. Port,3046,618,3664
725,200906,2009,6,Sarria,2454,10318,12772
726,200907,2009,7,Astorga,1309,5920,7229
727,200907,2009,7,Cebreiro,2002,9539,11541
728,200907,2009,7,León,1623,4297,5920
729,200907,2009,7,Pamplona,563,3734,4297
730,200907,2009,7,Ponferrada,1684,7229,8913
731,200907,2009,7,Resto,9216,0,9216
732,200907,2009,7,Roncesvalles,1665,2069,3734
733,200907,2009,7,S. Jean P. Port,2069,0,2069
734,200907,2009,7,Sarria,5055,11541,16596
735,200907,2009,7,Tui,940,0,940
736,200907,2009,7,Vilafranca,626,8913,9539
737,200908,2009,8,Astorga,1256,8707,9963
738,200908,2009,8,Burgos,907,5461,6368
739,200908,2009,8,Cebreiro,2708,13108,15816
740,200908,2009,8,León,2339,6368,8707
741,200908,2009,8,Ponferrada,2366,9963,12329
742,200908,2009,8,Resto,11273,0,11273
743,200908,2009,8,Roncesvalles,2791,2670,5461
744,200908,2009,8,S. Jean P. Port,2670,0,2670
745,200908,2009,8,Sarria,7415,15816,23231
746,200908,2009,8,Tui,1042,0,1042
747,200908,2009,8,Vilafranca,779,12329,13108
748,200909,2009,9,Astorga,886,7138,8024
749,200909,2009,9,Burgos,611,5034,5645
750,200909,2009,9,Cebreiro,1264,9139,10403
751,200909,2009,9,Le Puy,527,0,527
752,200909,2009,9,León,1493,5645,7138
753,200909,2009,9,Pamplona,677,4357,5034
754,200909,2009,9,Ponferrada,1115,8024,9139
755,200909,2009,9,Resto,6389,0,6389
756,200909,2009,9,Roncesvalles,1461,2896,4357
757,200909,2009,9,S. Jean P. Port,2369,527,2896
758,200909,2009,9,Sarria,3831,10403,14234
759,200910,2009,10,Astorga,458,4893,5351
760,200910,2009,10,Burgos,348,3846,4194
761,200910,2009,10,Cebreiro,506,5806,6312
762,200910,2009,10,Le Puy,442,0,442
763,200910,2009,10,León,699,4194,4893
764,200910,2009,10,Pamplona,400,3446,3846
765,200910,2009,10,Ponferrada,455,5351,5806
766,200910,2009,10,Resto,3764,0,3764
767,200910,2009,10,Roncesvalles,980,2466,3446
768,200910,2009,10,S. Jean P. Port,2024,442,2466
769,200910,2009,10,Sarria,1655,6312,7967
770,200911,2009,11,Astorga,81,1084,1165
771,200911,2009,11,Cebreiro,103,1274,1377
772,200911,2009,11,Francia - C.F.,72,0,72
773,200911,2009,11,Le Puy,109,0,109
774,200911,2009,11,León,117,967,1084
775,200911,2009,11,Pamplona,70,897,967
776,200911,2009,11,Ponferrada,109,1165,1274
777,200911,2009,11,Resto,731,0,731
778,200911,2009,11,Roncesvalles,238,659,897
779,200911,2009,11,S. Jean P. Port,478,181,659
780,200911,2009,11,Sarria,245,1377,1622
781,200912,2009,12,Astorga,23,228,251
782,200912,2009,12,Cebreiro,69,285,354
783,200912,2009,12,León,39,189,228
784,200912,2009,12,Oporto,61,0,61
785,200912,2009,12,Oviedo - C.P.,28,0,28
786,200912,2009,12,Ponferrada,34,251,285
787,200912,2009,12,Resto,319,0,319
788,200912,2009,12,Roncesvalles,71,118,189
789,200912,2009,12,S. Jean P. Port,118,0,118
790,200912,2009,12,Sarria,170,354,524
791,200912,2009,12,Tui,78,61,139
792,201001,2010,1,Astorga,56,221,277
793,201001,2010,1,Cebreiro,106,346,452
794,201001,2010,1,León,48,173,221
795,201001,2010,1,Ponferrada,69,277,346
796,201001,2010,1,Resto,293,0,293
797,201001,2010,1,Resto C. León C.F.,78,0,78
798,201001,2010,1,Roncesvalles,37,58,95
799,201001,2010,1,S. Jean P. Port,58,0,58
800,201001,2010,1,Sarria,318,452,770
801,201001,2010,1,Tui,58,0,58
802,201001,2010,1,Vilalba,67,0,67
803,201002,2010,2,Astorga,44,279,323
804,201002,2010,2,Cebreiro,321,403,724
805,201002,2010,2,León,54,225,279
806,201002,2010,2,Oporto,48,0,48
807,201002,2010,2,Pamplona,38,187,225
808,201002,2010,2,Ponferrada,80,323,403
809,201002,2010,2,Resto,403,0,403
810,201002,2010,2,Roncesvalles,102,85,187
811,201002,2010,2,S. Jean P. Port,85,0,85
812,201002,2010,2,Sarria,354,724,1078
813,201002,2010,2,Tui,111,48,159
814,201003,2010,3,Cebreiro,446,962,1408
815,201003,2010,3,Ferrol,161,0,161
816,201003,2010,3,León,225,493,718
817,201003,2010,3,Ourense,227,0,227
818,201003,2010,3,Ponferrada,244,718,962
819,201003,2010,3,Resto,1550,0,1550
820,201003,2010,3,Roncesvalles,304,189,493
821,201003,2010,3,S. Jean P. Port,189,0,189
822,201003,2010,3,Sarria,1839,1408,3247
823,201003,2010,3,Tui,452,246,698
824,201003,2010,3,Valença do Minho,246,0,246
825,201004,2010,4,Cebreiro,2186,3543,5729
826,201004,2010,4,León,830,1814,2644
827,201004,2010,4,Oporto,482,0,482
828,201004,2010,4,Ourense,499,0,499
829,201004,2010,4,Ponferrada,899,2644,3543
830,201004,2010,4,Resto,5814,0,5814
831,201004,2010,4,Roncesvalles,990,824,1814
832,201004,2010,4,S. Jean P. Port,824,0,824
833,201004,2010,4,Sarria,5049,5729,10778
834,201004,2010,4,Tui,1487,1009,2496
835,201004,2010,4,Valença do Minho,527,482,1009
836,201005,2010,5,Astorga,851,6514,7365
837,201005,2010,5,Cebreiro,2362,8718,11080
838,201005,2010,5,León,1479,5035,6514
839,201005,2010,5,Oporto,1051,0,1051
840,201005,2010,5,Pamplona,679,4356,5035
841,201005,2010,5,Ponferrada,1353,7365,8718
842,201005,2010,5,Resto,9298,0,9298
843,201005,2010,5,Roncesvalles,1761,2595,4356
844,201005,2010,5,S. Jean P. Port,2595,0,2595
845,201005,2010,5,Sarria,5791,11080,16871
846,201005,2010,5,Tui,1626,1051,2677
847,201006,2010,6,Astorga,885,7603,8488
848,201006,2010,6,Cebreiro,2569,9854,12423
849,201006,2010,6,León,1598,6005,7603
850,201006,2010,6,Oporto,879,0,879
851,201006,2010,6,Pamplona,735,5270,6005
852,201006,2010,6,Ponferrada,1366,8488,9854
853,201006,2010,6,Resto,11876,0,11876
854,201006,2010,6,Roncesvalles,2148,3122,5270
855,201006,2010,6,S. Jean P. Port,3122,0,3122
856,201006,2010,6,Sarria,6962,12423,19385
857,201006,2010,6,Tui,1616,879,2495
858,201007,2010,7,Astorga,1501,6064,7565
859,201007,2010,7,Cebreiro,3283,10790,14073
860,201007,2010,7,León,1718,4346,6064
861,201007,2010,7,Ourense,1032,0,1032
862,201007,2010,7,Ponferrada,2264,7565,9829
863,201007,2010,7,Resto,13905,0,13905
864,201007,2010,7,Roncesvalles,1806,2540,4346
865,201007,2010,7,S. Jean P. Port,2540,0,2540
866,201007,2010,7,Sarria,10417,14073,24490
867,201007,2010,7,Tui,3039,0,3039
868,201007,2010,7,Vilafranca,961,9829,10790
869,201008,2010,8,Astorga,1668,7922,9590
870,201008,2010,8,Cebreiro,4129,12603,16732
871,201008,2010,8,León,2470,5452,7922
872,201008,2010,8,Ourense,2339,0,2339
873,201008,2010,8,Ponferrada,3013,9590,12603
874,201008,2010,8,Resto,20250,0,20250
875,201008,2010,8,Resto Asturias - C.N,1940,0,1940
876,201008,2010,8,Roncesvalles,2718,2734,5452
877,201008,2010,8,S. Jean P. Port,2734,0,2734
878,201008,2010,8,Sarria,15530,16732,32262
879,201008,2010,8,Tui,4743,0,4743
880,201009,2010,9,Astorga,934,6822,7756
881,201009,2010,9,Cebreiro,2831,9525,12356
882,201009,2010,9,Le Puy,712,0,712
883,201009,2010,9,León,1918,4904,6822
884,201009,2010,9,Oporto,833,0,833
885,201009,2010,9,Ponferrada,1769,7756,9525
886,201009,2010,9,Resto,11168,0,11168
887,201009,2010,9,Roncesvalles,1705,3199,4904
888,201009,2010,9,S. Jean P. Port,2487,712,3199
889,201009,2010,9,Sarria,10628,12356,22984
890,201009,2010,9,Tui,1863,833,2696
891,201010,2010,10,Astorga,636,4810,5446
892,201010,2010,10,Cebreiro,2163,6652,8815
893,201010,2010,10,León,1006,3804,4810
894,201010,2010,10,Oporto,652,0,652
895,201010,2010,10,Ourense,514,0,514
896,201010,2010,10,Ponferrada,1206,5446,6652
897,201010,2010,10,Resto,7798,0,7798
898,201010,2010,10,Roncesvalles,1417,2387,3804
899,201010,2010,10,S. Jean P. Port,2387,0,2387
900,201010,2010,10,Sarria,7272,8815,16087
901,201010,2010,10,Tui,1547,652,2199
902,201011,2010,11,Cebreiro,842,1615,2457
903,201011,2010,11,Ferrol,161,0,161
904,201011,2010,11,León,231,1038,1269
905,201011,2010,11,Ourense,241,0,241
906,201011,2010,11,Oviedo - C.P.,135,0,135
907,201011,2010,11,Ponferrada,346,1269,1615
908,201011,2010,11,Resto,2416,0,2416
909,201011,2010,11,Roncesvalles,438,600,1038
910,201011,2010,11,S. Jean P. Port,600,0,600
911,201011,2010,11,Sarria,1907,2457,4364
912,201011,2010,11,Tui,758,0,758
913,201012,2010,12,Cebreiro,862,706,1568
914,201012,2010,12,Ferrol,224,0,224
915,201012,2010,12,León,104,393,497
916,201012,2010,12,Ourense,188,0,188
917,201012,2010,12,Oviedo - C.P.,111,0,111
918,201012,2010,12,Ponferrada,209,497,706
919,201012,2010,12,Resto,1452,0,1452
920,201012,2010,12,Roncesvalles,204,189,393
921,201012,2010,12,S. Jean P. Port,189,0,189
922,201012,2010,12,Sarria,1681,1568,3249
923,201012,2010,12,Tui,743,0,743
924,201101,2011,1,Astorga,27,139,166
925,201101,2011,1,Cebreiro,63,196,259
926,201101,2011,1,León,45,94,139
927,201101,2011,1,Mondoñedo,20,0,20
928,201101,2011,1,Oporto,25,0,25
929,201101,2011,1,Ponferrada,30,166,196
930,201101,2011,1,Resto,183,0,183
931,201101,2011,1,Roncesvalles,27,67,94
932,201101,2011,1,S. Jean P. Port,67,0,67
933,201101,2011,1,Sarria,136,259,395
934,201101,2011,1,Tui,21,25,46
935,201102,2011,2,Cebreiro,112,236,348
936,201102,2011,2,León,51,133,184
937,201102,2011,2,Oporto,25,29,54
938,201102,2011,2,Pamplona,25,108,133
939,201102,2011,2,Ponferrada,52,184,236
940,201102,2011,2,Resto,240,0,240
941,201102,2011,2,Resto Portugal,29,0,29
942,201102,2011,2,Roncesvalles,38,70,108
943,201102,2011,2,S. Jean P. Port,70,0,70
944,201102,2011,2,Sarria,152,348,500
945,201102,2011,2,Tui,26,54,80
946,201103,2011,3,Cebreiro,288,506,794
947,201103,2011,3,León,143,221,364
948,201103,2011,3,Oporto,125,287,412
949,201103,2011,3,Ourense,215,0,215
950,201103,2011,3,Ponferrada,142,364,506
951,201103,2011,3,Resto,787,0,787
952,201103,2011,3,Resto Portugal,287,0,287
953,201103,2011,3,Roncesvalles,90,131,221
954,201103,2011,3,S. Jean P. Port,131,0,131
955,201103,2011,3,Sarria,719,794,1513
956,201103,2011,3,Tui,96,412,508
957,201104,2011,4,Astorga,382,2005,2387
958,201104,2011,4,Cebreiro,839,2991,3830
959,201104,2011,4,León,696,1309,2005
960,201104,2011,4,Oporto,638,0,638
961,201104,2011,4,Ponferrada,604,2387,2991
962,201104,2011,4,Resto,4045,0,4045
963,201104,2011,4,Roncesvalles,551,758,1309
964,201104,2011,4,S. Jean P. Port,758,0,758
965,201104,2011,4,Sarria,4396,3830,8226
966,201104,2011,4,Tui,762,1121,1883
967,201104,2011,4,Valença do Minho,483,638,1121
968,201105,2011,5,Astorga,662,5589,6251
969,201105,2011,5,Cebreiro,901,6965,7866
970,201105,2011,5,León,1269,4320,5589
971,201105,2011,5,Oporto,1007,0,1007
972,201105,2011,5,Pamplona,718,3602,4320
973,201105,2011,5,Ponferrada,714,6251,6965
974,201105,2011,5,Resto,6894,0,6894
975,201105,2011,5,Roncesvalles,984,2618,3602
976,201105,2011,5,S. Jean P. Port,2618,0,2618
977,201105,2011,5,Sarria,3400,7866,11266
978,201105,2011,5,Tui,638,1007,1645
979,201106,2011,6,Astorga,769,7513,8282
980,201106,2011,6,Cebreiro,948,9110,10058
981,201106,2011,6,León,1553,5960,7513
982,201106,2011,6,Oporto,1288,0,1288
983,201106,2011,6,Pamplona,753,5207,5960
984,201106,2011,6,Ponferrada,828,8282,9110
985,201106,2011,6,Resto,9008,0,9008
986,201106,2011,6,Roncesvalles,1402,3805,5207
987,201106,2011,6,S. Jean P. Port,3805,0,3805
988,201106,2011,6,Sarria,4065,10058,14123
989,201106,2011,6,Tui,820,1288,2108
990,201107,2011,7,Astorga,1444,5750,7194
991,201107,2011,7,Cebreiro,1866,8768,10634
992,201107,2011,7,León,1644,4106,5750
993,201107,2011,7,Oporto,726,0,726
994,201107,2011,7,Oviedo - C.P.,667,0,667
995,201107,2011,7,Ponferrada,1574,7194,8768
996,201107,2011,7,Resto,10588,0,10588
997,201107,2011,7,Roncesvalles,1568,2538,4106
998,201107,2011,7,S. Jean P. Port,2538,0,2538
999,201107,2011,7,Sarria,6900,10634,17534
1000,201107,2011,7,Tui,1327,726,2053
1001,201108,2011,8,Astorga,1194,8790,9984
1002,201108,2011,8,Burgos,916,5499,6415
1003,201108,2011,8,Cebreiro,2492,12078,14570
1004,201108,2011,8,León,2375,6415,8790
1005,201108,2011,8,Oviedo - C.P.,944,0,944
1006,201108,2011,8,Ponferrada,2094,9984,12078
1007,201108,2011,8,Resto,13710,0,13710
1008,201108,2011,8,Roncesvalles,2333,3166,5499
1009,201108,2011,8,S. Jean P. Port,3166,0,3166
1010,201108,2011,8,Sarria,10248,14570,24818
1011,201108,2011,8,Tui,2017,0,2017
1012,201109,2011,9,Astorga,855,6579,7434
1013,201109,2011,9,Cebreiro,1390,8701,10091
1014,201109,2011,9,León,1901,4678,6579
1015,201109,2011,9,Oporto,1095,0,1095
1016,201109,2011,9,Pamplona,675,4003,4678
1017,201109,2011,9,Ponferrada,1267,7434,8701
1018,201109,2011,9,Resto,8512,0,8512
1019,201109,2011,9,Roncesvalles,1292,2711,4003
1020,201109,2011,9,S. Jean P. Port,2711,0,2711
1021,201109,2011,9,Sarria,5220,10091,15311
1022,201109,2011,9,Tui,1105,1095,2200
1023,201110,2011,10,Astorga,431,4839,5270
1024,201110,2011,10,Cebreiro,981,5855,6836
1025,201110,2011,10,Le Puy,450,0,450
1026,201110,2011,10,León,798,4041,4839
1027,201110,2011,10,Oporto,661,0,661
1028,201110,2011,10,Ponferrada,585,5270,5855
1029,201110,2011,10,Resto,5135,0,5135
1030,201110,2011,10,Roncesvalles,829,3212,4041
1031,201110,2011,10,S. Jean P. Port,2762,450,3212
1032,201110,2011,10,Sarria,2958,6836,9794
1033,201110,2011,10,Tui,653,661,1314
1034,201111,2011,11,Astorga,82,1101,1183
1035,201111,2011,11,Cebreiro,185,1363,1548
1036,201111,2011,11,Le Puy,79,0,79
1037,201111,2011,11,León,142,959,1101
1038,201111,2011,11,Pamplona,90,869,959
1039,201111,2011,11,Ponferrada,180,1183,1363
1040,201111,2011,11,Resto,1198,0,1198
1041,201111,2011,11,Roncesvalles,159,710,869
1042,201111,2011,11,S. Jean P. Port,631,79,710
1043,201111,2011,11,Sarria,688,1548,2236
1044,201111,2011,11,Tui,157,0,157
1045,201112,2011,12,Cebreiro,103,388,491
1046,201112,2011,12,León,45,271,316
1047,201112,2011,12,Oporto,39,41,80
1048,201112,2011,12,Pamplona,38,233,271
1049,201112,2011,12,Ponferrada,72,316,388
1050,201112,2011,12,Resto,551,0,551
1051,201112,2011,12,Resto Portugal,41,0,41
1052,201112,2011,12,Roncesvalles,76,157,233
1053,201112,2011,12,S. Jean P. Port,157,0,157
1054,201112,2011,12,Sarria,279,491,770
1055,201112,2011,12,Tui,97,80,177
1056,201201,2012,1,Astorga,29,188,217
1057,201201,2012,1,Cebreiro,64,267,331
1058,201201,2012,1,León,82,106,188
1059,201201,2012,1,Oporto,34,0,34
1060,201201,2012,1,Oviedo - C.P.,49,0,49
1061,201201,2012,1,Ponferrada,50,217,267
1062,201201,2012,1,Resto,230,0,230
1063,201201,2012,1,Roncesvalles,30,76,106
1064,201201,2012,1,S. Jean P. Port,76,0,76
1065,201201,2012,1,Sarria,196,331,527
1066,201201,2012,1,Tui,32,34,66
1067,201202,2012,2,Cebreiro,200,226,426
1068,201202,2012,2,León,42,152,194
1069,201202,2012,2,Oporto,67,0,67
1070,201202,2012,2,Oviedo - C.P.,30,0,30
1071,201202,2012,2,Ponferrada,32,194,226
1072,201202,2012,2,Resto,309,0,309
1073,201202,2012,2,Roncesvalles,55,97,152
1074,201202,2012,2,S. Jean P. Port,97,0,97
1075,201202,2012,2,Sarria,323,426,749
1076,201202,2012,2,Tui,80,137,217
1077,201202,2012,2,Valença do Minho,70,67,137
1078,201203,2012,3,Cebreiro,132,678,810
1079,201203,2012,3,León,147,403,550
1080,201203,2012,3,Oporto,172,0,172
1081,201203,2012,3,Pamplona,67,336,403
1082,201203,2012,3,Ponferrada,128,550,678
1083,201203,2012,3,Resto,1017,0,1017
1084,201203,2012,3,Roncesvalles,113,223,336
1085,201203,2012,3,S. Jean P. Port,223,0,223
1086,201203,2012,3,Sarria,978,810,1788
1087,201203,2012,3,Tui,163,292,455
1088,201203,2012,3,Valença do Minho,120,172,292
1089,201204,2012,4,Cebreiro,793,2779,3572
1090,201204,2012,4,León,670,1526,2196
1091,201204,2012,4,Oporto,962,346,1308
1092,201204,2012,4,Ponferrada,583,2196,2779
1093,201204,2012,4,Resto,4850,0,4850
1094,201204,2012,4,Resto Portugal,346,0,346
1095,201204,2012,4,Roncesvalles,583,943,1526
1096,201204,2012,4,S. Jean P. Port,943,0,943
1097,201204,2012,4,Sarria,3936,3572,7508
1098,201204,2012,4,Tui,602,1789,2391
1099,201204,2012,4,Valença do Minho,481,1308,1789
1100,201205,2012,5,Cebreiro,912,7374,8286
1101,201205,2012,5,Le Puy,606,0,606
1102,201205,2012,5,León,1297,5389,6686
1103,201205,2012,5,Oporto,1247,0,1247
1104,201205,2012,5,Pamplona,676,4713,5389
1105,201205,2012,5,Ponferrada,688,6686,7374
1106,201205,2012,5,Resto,7479,0,7479
1107,201205,2012,5,Roncesvalles,1053,3660,4713
1108,201205,2012,5,S. Jean P. Port,3054,606,3660
1109,201205,2012,5,Sarria,4058,8286,12344
1110,201205,2012,5,Tui,706,1247,1953
1111,201206,2012,6,Astorga,633,7526,8159
1112,201206,2012,6,Cebreiro,1008,9028,10036
1113,201206,2012,6,León,1528,5998,7526
1114,201206,2012,6,Oporto,1065,0,1065
1115,201206,2012,6,Pamplona,735,5263,5998
1116,201206,2012,6,Ponferrada,869,8159,9028
1117,201206,2012,6,Resto,9079,0,9079
1118,201206,2012,6,Roncesvalles,1393,3870,5263
1119,201206,2012,6,S. Jean P. Port,3870,0,3870
1120,201206,2012,6,Sarria,4362,10036,14398
1121,201206,2012,6,Tui,975,1065,2040
1122,201207,2012,7,Astorga,1523,5516,7039
1123,201207,2012,7,Cebreiro,2074,8429,10503
1124,201207,2012,7,León,1522,3994,5516
1125,201207,2012,7,Oporto,867,0,867
1126,201207,2012,7,Oviedo - C.P.,645,0,645
1127,201207,2012,7,Ponferrada,1390,7039,8429
1128,201207,2012,7,Resto,11971,0,11971
1129,201207,2012,7,Roncesvalles,1176,2818,3994
1130,201207,2012,7,S. Jean P. Port,2818,0,2818
1131,201207,2012,7,Sarria,7160,10503,17663
1132,201207,2012,7,Tui,1672,867,2539
1133,201208,2012,8,Astorga,1048,7518,8566
1134,201208,2012,8,Cebreiro,2367,10578,12945
1135,201208,2012,8,Ferrol,1058,0,1058
1136,201208,2012,8,León,2229,5289,7518
1137,201208,2012,8,Oporto,1067,0,1067
1138,201208,2012,8,Ponferrada,2012,8566,10578
1139,201208,2012,8,Resto,14372,0,14372
1140,201208,2012,8,Roncesvalles,1816,3473,5289
1141,201208,2012,8,S. Jean P. Port,3473,0,3473
1142,201208,2012,8,Sarria,9474,12945,22419
1143,201208,2012,8,Tui,2180,1067,3247
1144,201209,2012,9,Astorga,838,5796,6634
1145,201209,2012,9,Cebreiro,1537,7848,9385
1146,201209,2012,9,León,1767,4029,5796
1147,201209,2012,9,Oporto,1093,0,1093
1148,201209,2012,9,Oviedo - C.P.,676,0,676
1149,201209,2012,9,Ponferrada,1214,6634,7848
1150,201209,2012,9,Resto,8929,0,8929
1151,201209,2012,9,Roncesvalles,1146,2883,4029
1152,201209,2012,9,S. Jean P. Port,2883,0,2883
1153,201209,2012,9,Sarria,6074,9385,15459
1154,201209,2012,9,Tui,1164,1093,2257
1155,201210,2012,10,Astorga,486,5912,6398
1156,201210,2012,10,Cebreiro,888,6990,7878
1157,201210,2012,10,León,908,5004,5912
1158,201210,2012,10,Oporto,887,0,887
1159,201210,2012,10,Pamplona,537,4467,5004
1160,201210,2012,10,Ponferrada,592,6398,6990
1161,201210,2012,10,Resto,5353,0,5353
1162,201210,2012,10,Roncesvalles,813,3654,4467
1163,201210,2012,10,S. Jean P. Port,3654,0,3654
1164,201210,2012,10,Sarria,3359,7878,11237
1165,201210,2012,10,Tui,614,887,1501
1166,201211,2012,11,Cebreiro,221,1628,1849
1167,201211,2012,11,Le Puy,113,0,113
1168,201211,2012,11,León,168,1310,1478
1169,201211,2012,11,Oporto,131,0,131
1170,201211,2012,11,Pamplona,100,1210,1310
1171,201211,2012,11,Ponferrada,150,1478,1628
1172,201211,2012,11,Resto,1416,0,1416
1173,201211,2012,11,Roncesvalles,201,1009,1210
1174,201211,2012,11,S. Jean P. Port,896,113,1009
1175,201211,2012,11,Sarria,597,1849,2446
1176,201211,2012,11,Tui,177,131,308
1177,201212,2012,12,Cebreiro,117,411,528
1178,201212,2012,12,Ferrol,55,0,55
1179,201212,2012,12,León,45,309,354
1180,201212,2012,12,Oporto,48,0,48
1181,201212,2012,12,Ponferrada,57,354,411
1182,201212,2012,12,Resto,534,0,534
1183,201212,2012,12,Roncesvalles,88,221,309
1184,201212,2012,12,S. Jean P. Port,221,0,221
1185,201212,2012,12,Sarria,214,528,742
1186,201212,2012,12,Tui,70,82,152
1187,201212,2012,12,Valença do Minho,34,48,82
1188,201301,2013,1,Cebreiro,39,257,296
1189,201301,2013,1,Gudiña,24,0,24
1190,201301,2013,1,León,47,182,229
1191,201301,2013,1,Oporto,34,0,34
1192,201301,2013,1,Pamplona,31,151,182
1193,201301,2013,1,Ponferrada,28,229,257
1194,201301,2013,1,Resto,248,0,248
1195,201301,2013,1,Roncesvalles,31,120,151
1196,201301,2013,1,S. Jean P. Port,120,0,120
1197,201301,2013,1,Sarria,159,296,455
1198,201301,2013,1,Tui,45,34,79
1199,201302,2013,2,Cebreiro,67,250,317
1200,201302,2013,2,León,48,169,217
1201,201302,2013,2,Oporto,63,0,63
1202,201302,2013,2,Ourense,51,0,51
1203,201302,2013,2,Ponferrada,33,217,250
1204,201302,2013,2,Resto,331,0,331
1205,201302,2013,2,Roncesvalles,50,119,169
1206,201302,2013,2,S. Jean P. Port,119,0,119
1207,201302,2013,2,Sarria,478,317,795
1208,201302,2013,2,Tui,96,109,205
1209,201302,2013,2,Valença do Minho,46,63,109
1210,201303,2013,3,Cebreiro,426,942,1368
1211,201303,2013,3,Ferrol,304,0,304
1212,201303,2013,3,León,187,487,674
1213,201303,2013,3,Oporto,261,0,261
1214,201303,2013,3,Ponferrada,268,674,942
1215,201303,2013,3,Resto,1723,0,1723
1216,201303,2013,3,Roncesvalles,215,272,487
1217,201303,2013,3,S. Jean P. Port,272,0,272
1218,201303,2013,3,Sarria,2625,1368,3993
1219,201303,2013,3,Tui,578,630,1208
1220,201303,2013,3,Valença do Minho,369,261,630
1221,201304,2013,4,Cebreiro,500,2713,3213
1222,201304,2013,4,León,565,1730,2295
1223,201304,2013,4,Oporto,827,0,827
1224,201304,2013,4,Pamplona,284,1446,1730
1225,201304,2013,4,Ponferrada,418,2295,2713
1226,201304,2013,4,Resto,3560,0,3560
1227,201304,2013,4,Roncesvalles,413,1033,1446
1228,201304,2013,4,S. Jean P. Port,1033,0,1033
1229,201304,2013,4,Sarria,3270,3213,6483
1230,201304,2013,4,Tui,346,1143,1489
1231,201304,2013,4,Valença do Minho,316,827,1143
1232,201305,2013,5,Astorga,744,6924,7668
1233,201305,2013,5,Cebreiro,972,8509,9481
1234,201305,2013,5,Le Puy,706,0,706
1235,201305,2013,5,León,1374,5550,6924
1236,201305,2013,5,Oporto,1521,0,1521
1237,201305,2013,5,Ponferrada,841,7668,8509
1238,201305,2013,5,Resto,8259,0,8259
1239,201305,2013,5,Roncesvalles,1020,4530,5550
1240,201305,2013,5,S. Jean P. Port,3824,706,4530
1241,201305,2013,5,Sarria,5195,9481,14676
1242,201305,2013,5,Tui,749,1521,2270
1243,201306,2013,6,Astorga,741,8550,9291
1244,201306,2013,6,Cebreiro,1247,10153,11400
1245,201306,2013,6,León,1546,7004,8550
1246,201306,2013,6,Oporto,1360,0,1360
1247,201306,2013,6,Pamplona,662,6342,7004
1248,201306,2013,6,Ponferrada,862,9291,10153
1249,201306,2013,6,Resto,10046,0,10046
1250,201306,2013,6,Roncesvalles,1461,4881,6342
1251,201306,2013,6,S. Jean P. Port,4881,0,4881
1252,201306,2013,6,Sarria,5627,11400,17027
1253,201306,2013,6,Tui,941,1360,2301
1254,201307,2013,7,Astorga,1566,6429,7995
1255,201307,2013,7,Cebreiro,2102,9465,11567
1256,201307,2013,7,León,1590,4839,6429
1257,201307,2013,7,Oporto,1150,0,1150
1258,201307,2013,7,Ponferrada,1470,7995,9465
1259,201307,2013,7,Resto,12208,0,12208
1260,201307,2013,7,Roncesvalles,1158,3681,4839
1261,201307,2013,7,S. Jean P. Port,3681,0,3681
1262,201307,2013,7,Sarria,8855,11567,20422
1263,201307,2013,7,Tui,1959,1970,3929
1264,201307,2013,7,Valença do Minho,820,1150,1970
1265,201308,2013,8,Cebreiro,2735,9852,12587
1266,201308,2013,8,Ferrol,1160,0,1160
1267,201308,2013,8,León,2299,5331,7630
1268,201308,2013,8,Oporto,1294,0,1294
1269,201308,2013,8,Oviedo - C.P.,1160,0,1160
1270,201308,2013,8,Ponferrada,2222,7630,9852
1271,201308,2013,8,Resto,15476,0,15476
1272,201308,2013,8,Roncesvalles,1645,3686,5331
1273,201308,2013,8,S. Jean P. Port,3686,0,3686
1274,201308,2013,8,Sarria,12557,12587,25144
1275,201308,2013,8,Tui,2492,1294,3786
1276,201309,2013,9,Astorga,880,6354,7234
1277,201309,2013,9,Cebreiro,1487,8621,10108
1278,201309,2013,9,León,1896,4458,6354
1279,201309,2013,9,Oporto,1388,0,1388
1280,201309,2013,9,Oviedo - C.P.,719,0,719
1281,201309,2013,9,Ponferrada,1387,7234,8621
1282,201309,2013,9,Resto,9384,0,9384
1283,201309,2013,9,Roncesvalles,1143,3315,4458
1284,201309,2013,9,S. Jean P. Port,3315,0,3315
1285,201309,2013,9,Sarria,7845,10108,17953
1286,201309,2013,9,Tui,1450,1388,2838
1287,201310,2013,10,Cebreiro,797,7692,8489
1288,201310,2013,10,Le Puy,460,0,460
1289,201310,2013,10,León,916,6191,7107
1290,201310,2013,10,Oporto,791,0,791
1291,201310,2013,10,Pamplona,511,5680,6191
1292,201310,2013,10,Ponferrada,585,7107,7692
1293,201310,2013,10,Resto,5590,0,5590
1294,201310,2013,10,Roncesvalles,824,4856,5680
1295,201310,2013,10,S. Jean P. Port,4396,460,4856
1296,201310,2013,10,Sarria,4175,8489,12664
1297,201310,2013,10,Tui,562,791,1353
1298,201311,2013,11,Cebreiro,222,1722,1944
1299,201311,2013,11,León,225,1307,1532
1300,201311,2013,11,Oporto,121,0,121
1301,201311,2013,11,Ourense,175,0,175
1302,201311,2013,11,Pamplona,121,1186,1307
1303,201311,2013,11,Ponferrada,190,1532,1722
1304,201311,2013,11,Resto,1538,0,1538
1305,201311,2013,11,Roncesvalles,176,1010,1186
1306,201311,2013,11,S. Jean P. Port,1010,0,1010
1307,201311,2013,11,Sarria,1027,1944,2971
1308,201311,2013,11,Tui,102,121,223
1309,201312,2013,12,Cebreiro,130,534,664
1310,201312,2013,12,León,49,365,414
1311,201312,2013,12,Lugo - C.P.,44,0,44
1312,201312,2013,12,Oporto,49,0,49
1313,201312,2013,12,Ponferrada,61,473,534
1314,201312,2013,12,Resto,577,0,577
1315,201312,2013,12,Roncesvalles,132,233,365
1316,201312,2013,12,S. Jean P. Port,233,0,233
1317,201312,2013,12,Sarria,250,664,914
1318,201312,2013,12,Sevilla,59,0,59
1319,201312,2013,12,Tui,75,49,124
1320,201401,2014,1,Cebreiro,39,266,305
1321,201401,2014,1,Ferrol,32,0,32
1322,201401,2014,1,León,50,185,235
1323,201401,2014,1,Oporto,51,0,51
1324,201401,2014,1,Pamplona,24,161,185
1325,201401,2014,1,Ponferrada,31,235,266
1326,201401,2014,1,Resto,260,0,260
1327,201401,2014,1,Roncesvalles,34,127,161
1328,201401,2014,1,S. Jean P. Port,127,0,127
1329,201401,2014,1,Sarria,212,305,517
1330,201401,2014,1,Tui,46,51,97
1331,201402,2014,2,León,41,216,257
1332,201402,2014,2,Oporto,30,0,30
1333,201402,2014,2,Pamplona,35,181,216
1334,201402,2014,2,Ponferrada,39,298,337
1335,201402,2014,2,Resto,265,0,265
1336,201402,2014,2,Roncesvalles,53,128,181
1337,201402,2014,2,S. Jean P. Port,128,0,128
1338,201402,2014,2,Sarria,269,337,606
1339,201402,2014,2,Sevilla,41,0,41
1340,201402,2014,2,Tui,32,67,99
1341,201402,2014,2,Valença do Minho,37,30,67
1342,201403,2014,3,Cebreiro,103,706,809
1343,201403,2014,3,Ferrol,121,0,121
1344,201403,2014,3,León,172,407,579
1345,201403,2014,3,Nájera,107,300,407
1346,201403,2014,3,Oporto,252,0,252
1347,201403,2014,3,Ponferrada,127,579,706
1348,201403,2014,3,Resto,1011,0,1011
1349,201403,2014,3,Roncesvalles,81,219,300
1350,201403,2014,3,S. Jean P. Port,219,0,219
1351,201403,2014,3,Sarria,845,809,1654
1352,201403,2014,3,Tui,112,252,364
1353,201404,2014,4,Cebreiro,841,2935,3776
1354,201404,2014,4,Ferrol,497,0,497
1355,201404,2014,4,León,675,1761,2436
1356,201404,2014,4,Oporto,1000,0,1000
1357,201404,2014,4,Ponferrada,499,2436,2935
1358,201404,2014,4,Resto,5031,0,5031
1359,201404,2014,4,Roncesvalles,473,1288,1761
1360,201404,2014,4,S. Jean P. Port,1288,0,1288
1361,201404,2014,4,Sarria,5457,3776,9233
1362,201404,2014,4,Tui,956,1630,2586
1363,201404,2014,4,Valença do Minho,630,1000,1630
1364,201405,2014,5,Cebreiro,1014,8608,9622
1365,201405,2014,5,Le Puy,674,0,674
1366,201405,2014,5,León,1444,6316,7760
1367,201405,2014,5,Oporto,1778,0,1778
1368,201405,2014,5,Pamplona,686,5630,6316
1369,201405,2014,5,Ponferrada,848,7760,8608
1370,201405,2014,5,Resto,8975,0,8975
1371,201405,2014,5,Roncesvalles,1012,4618,5630
1372,201405,2014,5,S. Jean P. Port,3944,674,4618
1373,201405,2014,5,Sarria,6007,9622,15629
1374,201405,2014,5,Tui,972,1778,2750
1375,201406,2014,6,Astorga,797,8515,9312
1376,201406,2014,6,Cebreiro,1136,10220,11356
1377,201406,2014,6,Ferrol,800,0,800
1378,201406,2014,6,León,1724,6791,8515
1379,201406,2014,6,Oporto,1491,0,1491
1380,201406,2014,6,Ponferrada,908,9312,10220
1381,201406,2014,6,Resto,11251,0,11251
1382,201406,2014,6,Roncesvalles,1391,5400,6791
1383,201406,2014,6,S. Jean P. Port,5400,0,5400
1384,201406,2014,6,Sarria,6790,11356,18146
1385,201406,2014,6,Tui,1333,1491,2824
1386,201407,2014,7,Astorga,1390,6688,8078
1387,201407,2014,7,Cebreiro,1985,9590,11575
1388,201407,2014,7,Ferrol,1421,0,1421
1389,201407,2014,7,León,1599,5089,6688
1390,201407,2014,7,Oporto,1378,0,1378
1391,201407,2014,7,Ponferrada,1512,8078,9590
1392,201407,2014,7,Resto,12960,0,12960
1393,201407,2014,7,Roncesvalles,1107,3982,5089
1394,201407,2014,7,S. Jean P. Port,3982,0,3982
1395,201407,2014,7,Sarria,10011,11575,21586
1396,201407,2014,7,Tui,2236,1378,3614
1397,201408,2014,8,Cebreiro,2764,10273,13037
1398,201408,2014,8,Ferrol,1888,0,1888
1399,201408,2014,8,León,2616,5597,8213
1400,201408,2014,8,Oporto,1438,0,1438
1401,201408,2014,8,Oviedo - C.P.,1276,0,1276
1402,201408,2014,8,Ponferrada,2060,8213,10273
1403,201408,2014,8,Resto,16586,0,16586
1404,201408,2014,8,Roncesvalles,1632,3965,5597
1405,201408,2014,8,S. Jean P. Port,3965,0,3965
1406,201408,2014,8,Sarria,13792,13037,26829
1407,201408,2014,8,Tui,3201,1438,4639
1408,201409,2014,9,Astorga,918,6845,7763
1409,201409,2014,9,Cebreiro,1328,8903,10231
1410,201409,2014,9,Ferrol,898,0,898
1411,201409,2014,9,León,1931,4914,6845
1412,201409,2014,9,Oporto,1911,0,1911
1413,201409,2014,9,Ponferrada,1140,7763,8903
1414,201409,2014,9,Resto,10897,0,10897
1415,201409,2014,9,Roncesvalles,1064,3850,4914
1416,201409,2014,9,S. Jean P. Port,3850,0,3850
1417,201409,2014,9,Sarria,8850,10231,19081
1418,201409,2014,9,Tui,1670,1911,3581
1419,201410,2014,10,Cebreiro,737,7728,8465
1420,201410,2014,10,Le Puy,508,0,508
1421,201410,2014,10,León,901,6186,7087
1422,201410,2014,10,Oporto,1048,0,1048
1423,201410,2014,10,Ponferrada,641,7087,7728
1424,201410,2014,10,Resto,7170,0,7170
1425,201410,2014,10,Resto Asturias - C.N,528,0,528
1426,201410,2014,10,Roncesvalles,723,5463,6186
1427,201410,2014,10,S. Jean P. Port,4955,508,5463
1428,201410,2014,10,Sarria,5250,8465,13715
1429,201410,2014,10,Tui,744,1048,1792
1430,201411,2014,11,Cebreiro,208,1869,2077
1431,201411,2014,11,Ferrol,116,0,116
1432,201411,2014,11,León,190,1567,1757
1433,201411,2014,11,Oporto,170,0,170
1434,201411,2014,11,Pamplona,154,1413,1567
1435,201411,2014,11,Ponferrada,112,1757,1869
1436,201411,2014,11,Resto,1530,0,1530
1437,201411,2014,11,Roncesvalles,184,1229,1413
1438,201411,2014,11,S. Jean P. Port,1229,0,1229
1439,201411,2014,11,Sarria,750,2077,2827
1440,201411,2014,11,Tui,160,170,330
1441,201412,2014,12,Cebreiro,76,483,559
1442,201412,2014,12,Ferrol,89,0,89
1443,201412,2014,12,León,67,354,421
1444,201412,2014,12,Oporto,89,0,89
1445,201412,2014,12,Ponferrada,62,421,483
1446,201412,2014,12,Resto,636,0,636
1447,201412,2014,12,Roncesvalles,94,260,354
1448,201412,2014,12,S. Jean P. Port,260,0,260
1449,201412,2014,12,Sarria,328,559,887
1450,201412,2014,12,Tui,114,144,258
1451,201412,2014,12,Valença do Minho,55,89,144
1452,201501,2015,1,Cebreiro,102,376,478
1453,201501,2015,1,Ferrol,50,0,50
1454,201501,2015,1,León,72,263,335
1455,201501,2015,1,Oporto,72,0,72
1456,201501,2015,1,Pamplona,46,217,263
1457,201501,2015,1,Ponferrada,41,335,376
1458,201501,2015,1,Resto,321,0,321
1459,201501,2015,1,Roncesvalles,31,186,217
1460,201501,2015,1,S. Jean P. Port,186,0,186
1461,201501,2015,1,Sarria,234,478,712
1462,201501,2015,1,Tui,62,72,134
1463,201502,2015,2,Cebreiro,96,339,435
1464,201502,2015,2,León,48,228,276
1465,201502,2015,2,Oporto,63,0,63
1466,201502,2015,2,Pamplona,52,176,228
1467,201502,2015,2,Ponferrada,63,276,339
1468,201502,2015,2,Resto,337,0,337
1469,201502,2015,2,S. Jean P. Port,176,0,176
1470,201502,2015,2,Sarria,528,483,1011
1471,201502,2015,2,Triacastela,48,435,483
1472,201502,2015,2,Tui,65,131,196
1473,201502,2015,2,Valença do Minho,68,63,131
1474,201503,2015,3,Cebreiro,293,761,1054
1475,201503,2015,3,Ferrol,137,0,137
1476,201503,2015,3,León,161,438,599
1477,201503,2015,3,Oporto,265,0,265
1478,201503,2015,3,Ponferrada,162,599,761
1479,201503,2015,3,Resto,1367,0,1367
1480,201503,2015,3,Roncesvalles,148,290,438
1481,201503,2015,3,S. Jean P. Port,290,0,290
1482,201503,2015,3,Sarria,1905,1054,2959
1483,201503,2015,3,Tui,186,431,617
1484,201503,2015,3,Valença do Minho,166,265,431
1485,201504,2015,4,Cebreiro,863,2923,3786
1486,201504,2015,4,Ferrol,661,0,661
1487,201504,2015,4,León,647,1732,2379
1488,201504,2015,4,Oporto,941,0,941
1489,201504,2015,4,Ponferrada,544,2379,2923
1490,201504,2015,4,Resto,4988,0,4988
1491,201504,2015,4,Roncesvalles,436,1296,1732
1492,201504,2015,4,S. Jean P. Port,1296,0,1296
1493,201504,2015,4,Sarria,5547,3786,9333
1494,201504,2015,4,Tui,1196,1543,2739
1495,201504,2015,4,Valença do Minho,602,941,1543
1496,201505,2015,5,Astorga,752,6938,7690
1497,201505,2015,5,Cebreiro,1001,8587,9588
1498,201505,2015,5,Ferrol,761,0,761
1499,201505,2015,5,León,1578,5360,6938
1500,201505,2015,5,Oporto,2363,0,2363
1501,201505,2015,5,Ponferrada,897,7690,8587
1502,201505,2015,5,Resto,10320,0,10320
1503,201505,2015,5,Roncesvalles,959,4401,5360
1504,201505,2015,5,S. Jean P. Port,4401,0,4401
1505,201505,2015,5,Sarria,6886,9588,16474
1506,201505,2015,5,Tui,1158,2363,3521
1507,201506,2015,6,Cebreiro,1319,9731,11050
1508,201506,2015,6,Ferrol,1052,0,1052
1509,201506,2015,6,León,1634,7019,8653
1510,201506,2015,6,Oporto,1735,0,1735
1511,201506,2015,6,Oviedo - C.P.,995,0,995
1512,201506,2015,6,Ponferrada,1078,8653,9731
1513,201506,2015,6,Resto,11390,0,11390
1514,201506,2015,6,Roncesvalles,1207,5812,7019
1515,201506,2015,6,S. Jean P. Port,5812,0,5812
1516,201506,2015,6,Sarria,8397,11050,19447
1517,201506,2015,6,Tui,1304,1735,3039
1518,201507,2015,7,Astorga,1451,5638,7089
1519,201507,2015,7,Cebreiro,1962,8726,10688
1520,201507,2015,7,Ferrol,1783,0,1783
1521,201507,2015,7,León,1604,4034,5638
1522,201507,2015,7,Oporto,1624,0,1624
1523,201507,2015,7,Oviedo - C.P.,1058,0,1058
1524,201507,2015,7,Ponferrada,1637,7089,8726
1525,201507,2015,7,Resto,15001,0,15001
1526,201507,2015,7,S. Jean P. Port,4034,0,4034
1527,201507,2015,7,Sarria,11462,10688,22150
1528,201507,2015,7,Tui,3178,1624,4802
1529,201508,2015,8,Cebreiro,2236,9781,12017
1530,201508,2015,8,Ferrol,2130,0,2130
1531,201508,2015,8,León,2422,5406,7828
1532,201508,2015,8,Oporto,2050,0,2050
1533,201508,2015,8,Oviedo - C.P.,1646,0,1646
1534,201508,2015,8,Ponferrada,1953,7828,9781
1535,201508,2015,8,Resto,17886,0,17886
1536,201508,2015,8,Roncesvalles,1505,3901,5406
1537,201508,2015,8,S. Jean P. Port,3901,0,3901
1538,201508,2015,8,Sarria,15266,12017,27283
1539,201508,2015,8,Tui,3799,2050,5849
1540,201509,2015,9,Cebreiro,1469,8084,9553
1541,201509,2015,9,Ferrol,1246,0,1246
1542,201509,2015,9,León,1993,4895,6888
1543,201509,2015,9,Oporto,2454,0,2454
1544,201509,2015,9,Oviedo - C.P.,1116,0,1116
1545,201509,2015,9,Ponferrada,1196,6888,8084
1546,201509,2015,9,Resto,11403,0,11403
1547,201509,2015,9,Roncesvalles,1072,3823,4895
1548,201509,2015,9,S. Jean P. Port,3823,0,3823
1549,201509,2015,9,Sarria,9864,9553,19417
1550,201509,2015,9,Tui,1793,2454,4247
1551,201510,2015,10,Cebreiro,728,8495,9223
1552,201510,2015,10,Ferrol,577,0,577
1553,201510,2015,10,León,1075,6770,7845
1554,201510,2015,10,Oporto,1327,0,1327
1555,201510,2015,10,Pamplona,562,6208,6770
1556,201510,2015,10,Ponferrada,650,7845,8495
1557,201510,2015,10,Resto,7635,0,7635
1558,201510,2015,10,Roncesvalles,750,5458,6208
1559,201510,2015,10,S. Jean P. Port,5458,0,5458
1560,201510,2015,10,Sarria,5986,9223,15209
1561,201510,2015,10,Tui,828,1327,2155
1562,201511,2015,11,Cebreiro,224,2050,2274
1563,201511,2015,11,Ferrol,164,0,164
1564,201511,2015,11,León,177,1745,1922
1565,201511,2015,11,Oporto,208,0,208
1566,201511,2015,11,Pamplona,158,1587,1745
1567,201511,2015,11,Ponferrada,128,1922,2050
1568,201511,2015,11,Resto,1578,0,1578
1569,201511,2015,11,Roncesvalles,201,1386,1587
1570,201511,2015,11,S. Jean P. Port,1386,0,1386
1571,201511,2015,11,Sarria,860,2274,3134
1572,201511,2015,11,Tui,144,208,352
1573,201512,2015,12,Cebreiro,57,494,551
1574,201512,2015,12,Ferrol,104,0,104
1575,201512,2015,12,León,84,357,441
1576,201512,2015,12,Oporto,96,0,96
1577,201512,2015,12,Ponferrada,53,441,494
1578,201512,2015,12,Resto,688,0,688
1579,201512,2015,12,Roncesvalles,65,292,357
1580,201512,2015,12,S. Jean P. Port,292,0,292
1581,201512,2015,12,Sarria,472,551,1023
1582,201512,2015,12,Tui,86,161,247
1583,201512,2015,12,Valença do Minho,65,96,161
1584,201601,2016,1,Astorga,44,286,330
1585,201601,2016,1,Cebreiro,57,374,431
1586,201601,2016,1,Ferrol,58,0,58
1587,201601,2016,1,León,75,211,286
1588,201601,2016,1,Oporto,66,0,66
1589,201601,2016,1,Pamplona,44,167,211
1590,201601,2016,1,Ponferrada,44,330,374
1591,201601,2016,1,Resto,406,0,406
1592,201601,2016,1,S. Jean P. Port,167,0,167
1593,201601,2016,1,Sarria,282,431,713
1594,201601,2016,1,Tui,61,66,127
1595,201602,2016,2,Cebreiro,113,444,557
1596,201602,2016,2,Ferrol,115,0,115
1597,201602,2016,2,León,89,302,391
1598,201602,2016,2,Oporto,104,0,104
1599,201602,2016,2,Pamplona,70,232,302
1600,201602,2016,2,Ponferrada,53,391,444
1601,201602,2016,2,Resto,375,0,375
1602,201602,2016,2,Roncesvalles,48,184,232
1603,201602,2016,2,S. Jean P. Port,184,0,184
1604,201602,2016,2,Sarria,505,557,1062
1605,201602,2016,2,Tui,77,104,181
1606,201603,2016,3,Cebreiro,501,1375,1876
1607,201603,2016,3,Ferrol,505,0,505
1608,201603,2016,3,León,301,714,1015
1609,201603,2016,3,Oporto,567,0,567
1610,201603,2016,3,Ponferrada,360,1015,1375
1611,201603,2016,3,Resto,2797,0,2797
1612,201603,2016,3,Roncesvalles,254,460,714
1613,201603,2016,3,S. Jean P. Port,460,0,460
1614,201603,2016,3,Sarria,4276,1876,6152
1615,201603,2016,3,Tui,645,968,1613
1616,201603,2016,3,Valença do Minho,401,567,968
1617,201604,2016,4,Cebreiro,451,2818,3269
1618,201604,2016,4,Ferrol,463,0,463
1619,201604,2016,4,León,682,1796,2478
1620,201604,2016,4,Oporto,1298,0,1298
1621,201604,2016,4,Ponferrada,340,2478,2818
1622,201604,2016,4,Resto,4578,0,4578
1623,201604,2016,4,Roncesvalles,319,1477,1796
1624,201604,2016,4,S. Jean P. Port,1477,0,1477
1625,201604,2016,4,Sarria,4396,3269,7665
1626,201604,2016,4,Tui,594,1800,2394
1627,201604,2016,4,Valença do Minho,502,1298,1800
1628,201605,2016,5,Cebreiro,874,8645,9519
1629,201605,2016,5,Ferrol,975,0,975
1630,201605,2016,5,León,1666,6080,7746
1631,201605,2016,5,Oporto,2843,0,2843
1632,201605,2016,5,Ponferrada,899,7746,8645
1633,201605,2016,5,Resto,10358,0,10358
1634,201605,2016,5,Roncesvalles,924,5156,6080
1635,201605,2016,5,S. Jean P. Port,5156,0,5156
1636,201605,2016,5,Sarria,7197,9519,16716
1637,201605,2016,5,Tui,1122,3605,4727
1638,201605,2016,5,Valença do Minho,762,2843,3605
1639,201606,2016,6,Cebreiro,1311,10065,11376
1640,201606,2016,6,Ferrol,1167,0,1167
1641,201606,2016,6,León,1770,7278,9048
1642,201606,2016,6,Oporto,2420,0,2420
1643,201606,2016,6,Oviedo - C.P.,1045,0,1045
1644,201606,2016,6,Ponferrada,1017,9048,10065
1645,201606,2016,6,Resto,12470,0,12470
1646,201606,2016,6,Roncesvalles,1034,6244,7278
1647,201606,2016,6,S. Jean P. Port,6244,0,6244
1648,201606,2016,6,Sarria,8994,11376,20370
1649,201606,2016,6,Tui,1598,2420,4018
1650,201607,2016,7,Astorga,1294,5927,7221
1651,201607,2016,7,Cebreiro,2146,8625,10771
1652,201607,2016,7,Ferrol,1836,0,1836
1653,201607,2016,7,León,1750,4177,5927
1654,201607,2016,7,Oporto,2180,0,2180
1655,201607,2016,7,Oviedo - C.P.,1153,0,1153
1656,201607,2016,7,Ponferrada,1404,7221,8625
1657,201607,2016,7,Resto,14468,0,14468
1658,201607,2016,7,S. Jean P. Port,4177,0,4177
1659,201607,2016,7,Sarria,11955,10771,22726
1660,201607,2016,7,Tui,3108,2180,5288
1661,201608,2016,8,Cebreiro,2095,8052,10147
1662,201608,2016,8,Ferrol,2176,0,2176
1663,201608,2016,8,León,2310,3942,6252
1664,201608,2016,8,Oporto,2465,0,2465
1665,201608,2016,8,Oviedo - C.P.,1757,0,1757
1666,201608,2016,8,Ponferrada,1800,6252,8052
1667,201608,2016,8,Resto,16653,0,16653
1668,201608,2016,8,S. Jean P. Port,3942,0,3942
1669,201608,2016,8,Sarria,14938,10147,25085
1670,201608,2016,8,Tui,4026,4007,8033
1671,201608,2016,8,Valença do Minho,1542,2465,4007
1672,201609,2016,9,Cebreiro,1297,8191,9488
1673,201609,2016,9,Ferrol,1233,0,1233
1674,201609,2016,9,León,1936,5018,6954
1675,201609,2016,9,Oporto,3252,0,3252
1676,201609,2016,9,Oviedo - C.P.,1109,0,1109
1677,201609,2016,9,Ponferrada,1237,6954,8191
1678,201609,2016,9,Resto,11666,0,11666
1679,201609,2016,9,Roncesvalles,864,4154,5018
1680,201609,2016,9,S. Jean P. Port,4154,0,4154
1681,201609,2016,9,Sarria,10900,9488,20388
1682,201609,2016,9,Tui,2501,3252,5753
1683,201610,2016,10,Cebreiro,717,8430,9147
1684,201610,2016,10,Ferrol,668,0,668
1685,201610,2016,10,León,1125,6490,7615
1686,201610,2016,10,Oporto,2052,0,2052
1687,201610,2016,10,Oviedo - C.P.,682,0,682
1688,201610,2016,10,Ponferrada,815,7615,8430
1689,201610,2016,10,Resto,8273,0,8273
1690,201610,2016,10,Roncesvalles,671,5819,6490
1691,201610,2016,10,S. Jean P. Port,5819,0,5819
1692,201610,2016,10,Sarria,6377,9147,15524
1693,201610,2016,10,Tui,1023,2052,3075
1694,201611,2016,11,Cebreiro,196,2115,2311
1695,201611,2016,11,Ferrol,173,0,173
1696,201611,2016,11,León,263,1852,2115
1697,201611,2016,11,Oporto,367,0,367
1698,201611,2016,11,Oviedo - C.P.,177,0,177
1699,201611,2016,11,Pamplona,167,1685,1852
1700,201611,2016,11,Resto,1847,0,1847
1701,201611,2016,11,Roncesvalles,167,1518,1685
1702,201611,2016,11,S. Jean P. Port,1518,0,1518
1703,201611,2016,11,Sarria,1245,2311,3556
1704,201611,2016,11,Tui,274,367,641
1705,201612,2016,12,Cebreiro,98,590,688
1706,201612,2016,12,Ferrol,109,0,109
1707,201612,2016,12,Oporto,112,0,112
1708,201612,2016,12,Ourense,132,0,132
1709,201612,2016,12,Ponferrada,93,497,590
1710,201612,2016,12,Resto,899,0,899
1711,201612,2016,12,Roncesvalles,139,358,497
1712,201612,2016,12,S. Jean P. Port,358,0,358
1713,201612,2016,12,Sarria,701,688,1389
1714,201612,2016,12,Tui,129,206,335
1715,201612,2016,12,Valença do Minho,94,112,206
1716,201701,2017,1,Cebreiro,42,356,398
1717,201701,2017,1,Ferrol,60,0,60
1718,201701,2017,1,León,76,231,307
1719,201701,2017,1,Oporto,102,0,102
1720,201701,2017,1,Pamplona,48,183,231
1721,201701,2017,1,Ponferrada,49,307,356
1722,201701,2017,1,Resto,380,0,380
1723,201701,2017,1,S. Jean P. Port,183,0,183
1724,201701,2017,1,Sarria,277,398,675
1725,201701,2017,1,Tui,92,147,239
1726,201701,2017,1,Valença do Minho,45,102,147
1727,201702,2017,2,Ferrol,46,0,46
1728,201702,2017,2,León,73,282,355
1729,201702,2017,2,Oporto,128,0,128
1730,201702,2017,2,Oviedo - C.P.,39,0,39
1731,201702,2017,2,Pamplona,49,233,282
1732,201702,2017,2,Ponferrada,50,355,405
1733,201702,2017,2,Resto,465,0,465
1734,201702,2017,2,S. Jean P. Port,233,0,233
1735,201702,2017,2,Sarria,494,405,899
1736,201702,2017,2,Tui,80,167,247
1737,201702,2017,2,Valença do Minho,39,128,167
1738,201703,2017,3,Cebreiro,249,715,964
1739,201703,2017,3,Ferrol,143,0,143
1740,201703,2017,3,León,182,384,566
1741,201703,2017,3,Oporto,603,0,603
1742,201703,2017,3,Pamplona,91,293,384
1743,201703,2017,3,Ponferrada,149,566,715
1744,201703,2017,3,Resto,1304,0,1304
1745,201703,2017,3,S. Jean P. Port,293,0,293
1746,201703,2017,3,Sarria,1559,964,2523
1747,201703,2017,3,Tui,388,818,1206
1748,201703,2017,3,Valença do Minho,215,603,818
1749,201704,2017,4,Cebreiro,1058,3581,4639
1750,201704,2017,4,Ferrol,1038,0,1038
1751,201704,2017,4,León,783,2159,2942
1752,201704,2017,4,Oporto,2197,0,2197
1753,201704,2017,4,Ponferrada,639,2942,3581
1754,201704,2017,4,Resto,7200,0,7200
1755,201704,2017,4,Roncesvalles,557,1602,2159
1756,201704,2017,4,S. Jean P. Port,1602,0,1602
1757,201704,2017,4,Sarria,9077,4639,13716
1758,201704,2017,4,Tui,1648,3323,4971
1759,201704,2017,4,Valença do Minho,1126,2197,3323
1760,201705,2017,5,Cebreiro,984,8401,9385
1761,201705,2017,5,Ferrol,1087,0,1087
1762,201705,2017,5,León,1668,5975,7643
1763,201705,2017,5,Oporto,3708,0,3708
1764,201705,2017,5,Oviedo - C.P.,940,0,940
1765,201705,2017,5,Ponferrada,758,7643,8401
1766,201705,2017,5,Resto,10956,0,10956
1767,201705,2017,5,Roncesvalles,775,5200,5975
1768,201705,2017,5,S. Jean P. Port,5200,0,5200
1769,201705,2017,5,Sarria,7860,9385,17245
1770,201705,2017,5,Tui,1411,3708,5119
1771,201706,2017,6,Cebreiro,1173,9636,10809
1772,201706,2017,6,Ferrol,1275,0,1275
1773,201706,2017,6,León,1702,6973,8675
1774,201706,2017,6,Oporto,3255,0,3255
1775,201706,2017,6,Oviedo - C.P.,1202,0,1202
1776,201706,2017,6,Ponferrada,961,8675,9636
1777,201706,2017,6,Resto,12397,0,12397
1778,201706,2017,6,Roncesvalles,876,6097,6973
1779,201706,2017,6,S. Jean P. Port,6097,0,6097
1780,201706,2017,6,Sarria,10685,10809,21494
1781,201706,2017,6,Tui,1996,3255,5251
1782,201707,2017,7,Astorga,1183,5672,6855
1783,201707,2017,7,Cebreiro,1744,8260,10004
1784,201707,2017,7,Ferrol,1936,0,1936
1785,201707,2017,7,León,1512,4160,5672
1786,201707,2017,7,Oporto,2490,0,2490
1787,201707,2017,7,Oviedo - C.P.,1258,0,1258
1788,201707,2017,7,Ponferrada,1405,6855,8260
1789,201707,2017,7,Resto,15963,0,15963
1790,201707,2017,7,S. Jean P. Port,4160,0,4160
1791,201707,2017,7,Sarria,11898,10004,21902
1792,201707,2017,7,Tui,3921,2490,6411
1793,201708,2017,8,Cebreiro,2071,7878,9949
1794,201708,2017,8,Ferrol,2503,0,2503
1795,201708,2017,8,León,2296,3919,6215
1796,201708,2017,8,Oporto,2957,0,2957
1797,201708,2017,8,Oviedo - C.P.,1760,0,1760
1798,201708,2017,8,Ponferrada,1663,6215,7878
1799,201708,2017,8,Resto,17009,0,17009
1800,201708,2017,8,S. Jean P. Port,3919,0,3919
1801,201708,2017,8,Sarria,16133,9949,26082
1802,201708,2017,8,Tui,6191,4135,10326
1803,201708,2017,8,Valença do Minho,1178,2957,4135
1804,201709,2017,9,Cebreiro,1393,6800,8193
1805,201709,2017,9,Ferrol,1404,0,1404
1806,201709,2017,9,León,1940,3796,5736
1807,201709,2017,9,Oporto,3573,0,3573
1808,201709,2017,9,Oviedo - C.P.,1273,0,1273
1809,201709,2017,9,Ponferrada,1064,5736,6800
1810,201709,2017,9,Resto,12083,0,12083
1811,201709,2017,9,S. Jean P. Port,3796,0,3796
1812,201709,2017,9,Sarria,12215,8193,20408
1813,201709,2017,9,Tui,2524,4497,7021
1814,201709,2017,9,Valença do Minho,924,3573,4497
1815,201710,2017,10,Cebreiro,981,8359,9340
1816,201710,2017,10,Ferrol,1025,0,1025
1817,201710,2017,10,León,1066,6578,7644
1818,201710,2017,10,Oporto,2572,0,2572
1819,201710,2017,10,Oviedo - C.P.,696,0,696
1820,201710,2017,10,Ponferrada,715,7644,8359
1821,201710,2017,10,Resto,8961,0,8961
1822,201710,2017,10,Roncesvalles,732,5846,6578
1823,201710,2017,10,S. Jean P. Port,5846,0,5846
1824,201710,2017,10,Sarria,7462,9340,16802
1825,201710,2017,10,Tui,1285,2572,3857
1826,201711,2017,11,Cebreiro,261,2009,2270
1827,201711,2017,11,Ferrol,196,0,196
1828,201711,2017,11,Irún,168,0,168
1829,201711,2017,11,León,253,1756,2009
1830,201711,2017,11,Oporto,569,0,569
1831,201711,2017,11,Oviedo - C.P.,191,0,191
1832,201711,2017,11,Resto,2298,0,2298
1833,201711,2017,11,Roncesvalles,238,1518,1756
1834,201711,2017,11,S. Jean P. Port,1518,0,1518
1835,201711,2017,11,Sarria,1319,2270,3589
1836,201711,2017,11,Tui,335,569,904
1837,201712,2017,12,Cebreiro,142,534,676
1838,201712,2017,12,Ferrol,109,0,109
1839,201712,2017,12,León,63,471,534
1840,201712,2017,12,Oporto,181,0,181
1841,201712,2017,12,Pamplona,57,414,471
1842,201712,2017,12,Resto,834,0,834
1843,201712,2017,12,Roncesvalles,84,330,414
1844,201712,2017,12,S. Jean P. Port,330,0,330
1845,201712,2017,12,Sarria,739,676,1415
1846,201712,2017,12,Tui,268,267,535
1847,201712,2017,12,Valença do Minho,86,181,267
1848,201801,2018,1,Astorga,21,406,427
1849,201801,2018,1,Burgos,28,286,314
1850,201801,2018,1,Cebreiro,74,497,571
1851,201801,2018,1,Ferrol,75,0,75
1852,201801,2018,1,León,79,314,393
1853,201801,2018,1,Lisboa,19,0,19
1854,201801,2018,1,Lugo - C.P.,25,76,101
1855,201801,2018,1,Oporto,121,0,121
1856,201801,2018,1,Oporto Costa,16,19,35
1857,201801,2018,1,Ourense,16,0,16
1858,201801,2018,1,Oviedo - C.P.,76,0,76
1859,201801,2018,1,Pamplona,54,232,286
1860,201801,2018,1,Ponferrada,54,427,481
1861,201801,2018,1,Resto,223,0,223
1862,201801,2018,1,Roncesvalles,31,201,232
1863,201801,2018,1,S. Jean P. Port,201,0,201
1864,201801,2018,1,Sarria,383,571,954
1865,201801,2018,1,Sevilla,13,0,13
1866,201801,2018,1,Tui,66,157,223
1867,201801,2018,1,Valença do Minho,36,121,157
1868,201801,2018,1,Vilafranca,16,481,497
1869,201802,2018,2,Astorga,30,341,371
1870,201802,2018,2,Cebreiro,75,417,492
1871,201802,2018,2,Ferrol,73,0,73
1872,201802,2018,2,León,53,266,319
1873,201802,2018,2,Lisboa,25,0,25
1874,201802,2018,2,Lugo - C.P.,38,31,69
1875,201802,2018,2,Oporto,197,42,239
1876,201802,2018,2,Ourense,30,0,30
1877,201802,2018,2,Oviedo - C.P.,31,0,31
1878,201802,2018,2,Pamplona,49,217,266
1879,201802,2018,2,Ponferrada,46,371,417
1880,201802,2018,2,Ponte de Lima,31,239,270
1881,201802,2018,2,Resto,324,0,324
1882,201802,2018,2,Resto Portugal,42,0,42
1883,201802,2018,2,Roncesvalles,37,180,217
1884,201802,2018,2,S. Jean P. Port,180,0,180
1885,201802,2018,2,Sarria,528,492,1020
1886,201802,2018,2,Sevilla,22,0,22
1887,201802,2018,2,Tui,152,460,612
1888,201802,2018,2,Valença do Minho,190,270,460
1889,201802,2018,2,Viana do Castelo,28,25,53
1890,201803,2018,3,Astorga,83,791,874
1891,201803,2018,3,Cebreiro,443,1059,1502
1892,201803,2018,3,Ferrol,371,0,371
1893,201803,2018,3,León,197,594,791
1894,201803,2018,3,Lugo - C.P.,126,136,262
1895,201803,2018,3,Oporto,853,0,853
1896,201803,2018,3,Oporto Costa,91,0,91
1897,201803,2018,3,Ourense,219,0,219
1898,201803,2018,3,Oviedo - C.P.,136,0,136
1899,201803,2018,3,Pamplona,81,513,594
1900,201803,2018,3,Ponferrada,185,874,1059
1901,201803,2018,3,Porriño,79,2315,2394
1902,201803,2018,3,Resto,1313,0,1313
1903,201803,2018,3,Roncesvalles,151,362,513
1904,201803,2018,3,S. Jean P. Port,362,0,362
1905,201803,2018,3,Sarria,4476,1581,6057
1906,201803,2018,3,Triacastela,79,1502,1581
1907,201803,2018,3,Tui,981,1334,2315
1908,201803,2018,3,Valença do Minho,481,853,1334
1909,201803,2018,3,Vigo,243,91,334
1910,201803,2018,3,Vilalba,106,0,106
1911,201804,2018,4,Astorga,287,2971,3258
1912,201804,2018,4,Cebreiro,444,3678,4122
1913,201804,2018,4,Ferrol,913,0,913
1914,201804,2018,4,Irún,198,0,198
1915,201804,2018,4,León,696,2057,2753
1916,201804,2018,4,Lugo - C.P.,275,428,703
1917,201804,2018,4,Oporto,2757,0,2757
1918,201804,2018,4,Oporto Costa,361,0,361
1919,201804,2018,4,Ourense,263,0,263
1920,201804,2018,4,Oviedo - C.P.,428,0,428
1921,201804,2018,4,Pamplona,232,1825,2057
1922,201804,2018,4,Ponferrada,420,3258,3678
1923,201804,2018,4,Ponte de Lima,191,2757,2948
1924,201804,2018,4,Resto,3460,0,3460
1925,201804,2018,4,Roncesvalles,317,1508,1825
1926,201804,2018,4,S. Jean P. Port,1508,0,1508
1927,201804,2018,4,Sarria,6613,4367,10980
1928,201804,2018,4,Sevilla,218,0,218
1929,201804,2018,4,Triacastela,245,4122,4367
1930,201804,2018,4,Tui,1251,3939,5190
1931,201804,2018,4,Valença do Minho,991,2948,3939
1932,201805,2018,5,León,1606,5535,7141
1933,201805,2018,5,Oporto,4602,0,4602
1934,201805,2018,5,Resto,17504,0,17504
1935,201805,2018,5,S. Jean P. Port,5535,0,5535
1936,201805,2018,5,Sarria,9633,7141,16774
1937,201805,2018,5,Tui,1785,4602,6387
1938,201806,2018,6,Astorga,530,10194,10724
1939,201806,2018,6,Burgos,462,8069,8531
1940,201806,2018,6,Cebreiro,1243,11645,12888
1941,201806,2018,6,Ferrol,1561,0,1561
1942,201806,2018,6,Irún,918,0,918
1943,201806,2018,6,Le Puy,574,0,574
1944,201806,2018,6,León,1663,8531,10194
1945,201806,2018,6,Lisboa,407,0,407
1946,201806,2018,6,Lugo - C.P.,433,1318,1751
1947,201806,2018,6,Oporto,3562,0,3562
1948,201806,2018,6,Oporto Costa,781,407,1188
1949,201806,2018,6,Ourense,433,0,433
1950,201806,2018,6,Oviedo - C.P.,1318,0,1318
1951,201806,2018,6,Pamplona,572,7497,8069
1952,201806,2018,6,Ponferrada,921,10724,11645
1953,201806,2018,6,Resto,8099,0,8099
1954,201806,2018,6,Roncesvalles,881,6616,7497
1955,201806,2018,6,S. Jean P. Port,6042,574,6616
1956,201806,2018,6,Sarria,11793,12888,24681
1957,201806,2018,6,Tui,2587,4467,7054
1958,201806,2018,6,Valença do Minho,905,3562,4467
1959,201807,2018,7,Astorga,1358,6457,7815
1960,201807,2018,7,Burgos,466,4622,5088
1961,201807,2018,7,Cebreiro,1578,9612,11190
1962,201807,2018,7,Ferrol,2742,0,2742
1963,201807,2018,7,Irún,860,0,860
1964,201807,2018,7,León,1369,5088,6457
1965,201807,2018,7,Lugo - C.P.,879,1321,2200
1966,201807,2018,7,Oporto,3057,0,3057
1967,201807,2018,7,Oporto Costa,820,0,820
1968,201807,2018,7,Ourense,906,0,906
1969,201807,2018,7,Oviedo - C.P.,1321,0,1321
1970,201807,2018,7,Ponferrada,1148,7815,8963
1971,201807,2018,7,Porriño,486,8502,8988
1972,201807,2018,7,Resto,9807,0,9807
1973,201807,2018,7,Ribadeo,456,860,1316
1974,201807,2018,7,Roncesvalles,710,3912,4622
1975,201807,2018,7,S. Jean P. Port,3912,0,3912
1976,201807,2018,7,Sarria,12898,11190,24088
1977,201807,2018,7,Tui,4035,4467,8502
1978,201807,2018,7,Valença do Minho,1410,3057,4467
1979,201807,2018,7,Vilafranca,649,8963,9612
1980,201808,2018,8,Astorga,764,6715,7479
1981,201808,2018,8,Cebreiro,1816,9685,11501
1982,201808,2018,8,Ferrol,2876,0,2876
1983,201808,2018,8,Irún,1067,0,1067
1984,201808,2018,8,León,1989,4726,6715
1985,201808,2018,8,Lugo - C.P.,992,2432,3424
1986,201808,2018,8,Oporto,3015,0,3015
1987,201808,2018,8,Oporto Costa,927,0,927
1988,201808,2018,8,Ourense,848,0,848
1989,201808,2018,8,Oviedo - C.P.,1907,0,1907
1990,201808,2018,8,Ponferrada,1699,7479,9178
1991,201808,2018,8,Resto,10348,0,10348
1992,201808,2018,8,Resto Asturias - C.N,525,0,525
1993,201808,2018,8,Roncesvalles,1026,3700,4726
1994,201808,2018,8,S. Jean P. Port,3700,0,3700
1995,201808,2018,8,Sarria,18274,12246,30520
1996,201808,2018,8,Triacastela,745,11501,12246
1997,201808,2018,8,Tui,5308,4581,9889
1998,201808,2018,8,Valença do Minho,1566,3015,4581
1999,201808,2018,8,Vigo,516,927,1443
2000,201808,2018,8,Vilafranca,507,9178,9685
2001,201809,2018,9,Astorga,728,7674,8402
2002,201809,2018,9,Baiona,480,1286,1766
2003,201809,2018,9,Burgos,471,5335,5806
2004,201809,2018,9,Cebreiro,1219,9409,10628
2005,201809,2018,9,Ferrol,1727,0,1727
2006,201809,2018,9,Irún,820,0,820
2007,201809,2018,9,Le Puy,526,0,526
2008,201809,2018,9,León,1868,5806,7674
2009,201809,2018,9,Lugo - C.P.,537,1371,1908
2010,201809,2018,9,Oporto,4526,0,4526
2011,201809,2018,9,Oporto Costa,1286,0,1286
2012,201809,2018,9,Ourense,442,0,442
2013,201809,2018,9,Oviedo - C.P.,1371,0,1371
2014,201809,2018,9,Pamplona,479,4856,5335
2015,201809,2018,9,Ponferrada,1007,8402,9409
2016,201809,2018,9,Resto,7417,0,7417
2017,201809,2018,9,Roncesvalles,728,4128,4856
2018,201809,2018,9,S. Jean P. Port,3602,526,4128
2019,201809,2018,9,Sarria,13293,10628,23921
2020,201809,2018,9,Tui,3221,5784,9005
2021,201809,2018,9,Valença do Minho,1258,4526,5784
2022,201810,2018,10,Astorga,407,8901,9308
2023,201810,2018,10,Burgos,330,7450,7780
2024,201810,2018,10,Cebreiro,887,9973,10860
2025,201810,2018,10,Ferrol,1212,0,1212
2026,201810,2018,10,Irún,671,0,671
2027,201810,2018,10,Le Puy,384,0,384
2028,201810,2018,10,León,1121,7780,8901
2029,201810,2018,10,Lisboa,364,0,364
2030,201810,2018,10,Lugo - C.P.,290,866,1156
2031,201810,2018,10,Oporto,3340,283,3623
2032,201810,2018,10,Oporto Costa,937,364,1301
2033,201810,2018,10,Oviedo - C.P.,866,0,866
2034,201810,2018,10,Pamplona,469,6981,7450
2035,201810,2018,10,Ponferrada,665,9308,9973
2036,201810,2018,10,Resto,5972,0,5972
2037,201810,2018,10,Resto Portugal,283,0,283
2038,201810,2018,10,Roncesvalles,706,6275,6981
2039,201810,2018,10,S. Jean P. Port,5891,384,6275
2040,201810,2018,10,Sarria,8486,10860,19346
2041,201810,2018,10,Tui,1503,4441,5944
2042,201810,2018,10,Valença do Minho,818,3623,4441
2043,201811,2018,11,Astorga,82,2388,2470
2044,201811,2018,11,Burgos,69,2026,2095
2045,201811,2018,11,Cebreiro,176,2607,2783
2046,201811,2018,11,Ferrol,262,0,262
2047,201811,2018,11,Irún,168,0,168
2048,201811,2018,11,Le Puy,135,0,135
2049,201811,2018,11,León,193,2095,2288
2050,201811,2018,11,Lisboa,87,0,87
2051,201811,2018,11,Oporto,618,0,618
2052,201811,2018,11,Oporto Costa,126,87,213
2053,201811,2018,11,Ourense,89,0,89
2054,201811,2018,11,Oviedo - C.P.,158,0,158
2055,201811,2018,11,Pamplona,120,1906,2026
2056,201811,2018,11,Ponferrada,137,2470,2607
2057,201811,2018,11,Resto,1252,0,1252
2058,201811,2018,11,Roncesvalles,167,1739,1906
2059,201811,2018,11,S. Jean P. Port,1604,135,1739
2060,201811,2018,11,Sarria,1632,2783,4415
2061,201811,2018,11,Sevilla,100,0,100
2062,201811,2018,11,Tui,302,792,1094
2063,201811,2018,11,Valença do Minho,174,618,792
2064,201812,2018,12,A Coruña,35,0,35
2065,201812,2018,12,Cebreiro,110,697,807
2066,201812,2018,12,Ferrol,121,0,121
2067,201812,2018,12,Irún,43,0,43
2068,201812,2018,12,León,81,483,564
2069,201812,2018,12,Lisboa,34,0,34
2070,201812,2018,12,Lugo - C.P.,31,73,104
2071,201812,2018,12,Oporto,191,0,191
2072,201812,2018,12,Oporto Costa,34,34,68
2073,201812,2018,12,Ourense,30,0,30
2074,201812,2018,12,Oviedo - C.P.,73,0,73
2075,201812,2018,12,Pamplona,54,429,483
2076,201812,2018,12,Ponferrada,69,594,663
2077,201812,2018,12,Resto,471,0,471
2078,201812,2018,12,Roncesvalles,67,362,429
2079,201812,2018,12,S. Jean P. Port,362,0,362
2080,201812,2018,12,Sarria,500,807,1307
2081,201812,2018,12,Sevilla,30,0,30
2082,201812,2018,12,Tui,116,258,374
2083,201812,2018,12,Valença do Minho,67,191,258
2084,201812,2018,12,Vilafranca,34,663,697
2085,201901,2019,1,Astorga,25,376,401
2086,201901,2019,1,Burgos,26,277,303
2087,201901,2019,1,Cebreiro,93,446,539
2088,201901,2019,1,Ferrol,82,0,82
2089,201901,2019,1,León,54,303,357
2090,201901,2019,1,Lisboa,22,0,22
2091,201901,2019,1,Logroño,17,260,277
2092,201901,2019,1,Lugo - C.P.,13,37,50
2093,201901,2019,1,Oporto,187,0,187
2094,201901,2019,1,Oporto Costa,20,22,42
2095,201901,2019,1,Ourense,15,0,15
2096,201901,2019,1,Oviedo - C.P.,37,0,37
2097,201901,2019,1,Pamplona,47,213,260
2098,201901,2019,1,Ponferrada,45,401,446
2099,201901,2019,1,Resto,239,0,239
2100,201901,2019,1,Roncesvalles,27,186,213
2101,201901,2019,1,S. Jean P. Port,186,0,186
2102,201901,2019,1,Sarria,333,539,872
2103,201901,2019,1,Sevilla,19,0,19
2104,201901,2019,1,Tui,106,245,351
2105,201901,2019,1,Valença do Minho,58,187,245
2106,201902,2019,2,Astorga,15,398,413
2107,201902,2019,2,Burgos,20,253,273
2108,201902,2019,2,Cebreiro,38,451,489
2109,201902,2019,2,Ferrol,94,0,94
2110,201902,2019,2,León,103,273,376
2111,201902,2019,2,Lisboa,22,0,22
2112,201902,2019,2,Lugo - C.P.,38,45,83
2113,201902,2019,2,Oporto,209,14,223
2114,201902,2019,2,Oporto Costa,45,22,67
2115,201902,2019,2,Oviedo - C.P.,45,0,45
2116,201902,2019,2,Pamplona,49,204,253
2117,201902,2019,2,Ponferrada,38,413,451
2118,201902,2019,2,Resto,262,0,262
2119,201902,2019,2,Resto Portugal,14,0,14
2120,201902,2019,2,Ribadeo,16,0,16
2121,201902,2019,2,Roncesvalles,23,181,204
2122,201902,2019,2,S. Jean P. Port,181,0,181
2123,201902,2019,2,Sarria,682,489,1171
2124,201902,2019,2,Sevilla,22,0,22
2125,201902,2019,2,Tui,75,351,426
2126,201902,2019,2,Valença do Minho,128,223,351
2127,201903,2019,3,Astorga,76,800,876
2128,201903,2019,3,Cebreiro,218,1034,1252
2129,201903,2019,3,Ferrol,372,0,372
2130,201903,2019,3,León,187,518,705
2131,201903,2019,3,Lisboa,64,0,64
2132,201903,2019,3,Lugo - C.P.,68,118,186
2133,201903,2019,3,Oporto,979,60,1039
2134,201903,2019,3,Oporto Costa,230,64,294
2135,201903,2019,3,Ourense,157,0,157
2136,201903,2019,3,Oviedo - C.P.,118,0,118
2137,201903,2019,3,Pamplona,76,442,518
2138,201903,2019,3,Ponferrada,158,876,1034
2139,201903,2019,3,Resto,951,0,951
2140,201903,2019,3,Resto Portugal,60,0,60
2141,201903,2019,3,Roncesvalles,100,342,442
2142,201903,2019,3,S. Jean P. Port,342,0,342
2143,201903,2019,3,Sarria,2243,1252,3495
2144,201903,2019,3,Sevilla,95,0,95
2145,201903,2019,3,Tui,581,1364,1945
2146,201903,2019,3,Valença do Minho,325,1039,1364
2147,201903,2019,3,Vigo,74,294,368
2148,201904,2019,4,Astorga,368,2839,3207
2149,201904,2019,4,Cebreiro,863,3763,4626
2150,201904,2019,4,Ferrol,1390,0,1390
2151,201904,2019,4,Irún,234,0,234
2152,201904,2019,4,León,742,2097,2839
2153,201904,2019,4,Lugo - C.P.,539,521,1060
2154,201904,2019,4,Oporto,2913,249,3162
2155,201904,2019,4,Oporto Costa,811,0,811
2156,201904,2019,4,Ourense,493,0,493
2157,201904,2019,4,Oviedo - C.P.,521,0,521
2158,201904,2019,4,Ponferrada,556,3207,3763
2159,201904,2019,4,Ponte de Lima,262,3162,3424
2160,201904,2019,4,Porriño,448,6931,7379
2161,201904,2019,4,Resto,4751,0,4751
2162,201904,2019,4,Resto Portugal,249,0,249
2163,201904,2019,4,Roncesvalles,419,1678,2097
2164,201904,2019,4,S. Jean P. Port,1678,0,1678
2165,201904,2019,4,Sarria,10638,4626,15264
2166,201904,2019,4,Tui,1786,5145,6931
2167,201904,2019,4,Valença do Minho,1721,3424,5145
2168,201904,2019,4,Vigo,340,811,1151
2169,201905,2019,5,Astorga,587,9366,9953
2170,201905,2019,5,Cebreiro,1094,10861,11955
2171,201905,2019,5,Ferrol,1702,0,1702
2172,201905,2019,5,Irún,655,0,655
2173,201905,2019,5,Le Puy,668,0,668
2174,201905,2019,5,León,1511,7348,8859
2175,201905,2019,5,Lisboa,466,0,466
2176,201905,2019,5,Lugo - C.P.,518,1167,1685
2177,201905,2019,5,Oporto,5416,0,5416
2178,201905,2019,5,Oporto Costa,1429,466,1895
2179,201905,2019,5,Oviedo - C.P.,1167,0,1167
2180,201905,2019,5,Pamplona,561,6787,7348
2181,201905,2019,5,Ponferrada,908,9953,10861
2182,201905,2019,5,Resto,7865,0,7865
2183,201905,2019,5,Roncesvalles,714,6073,6787
2184,201905,2019,5,S. Jean P. Port,5405,668,6073
2185,201905,2019,5,Samos,398,0,398
2186,201905,2019,5,Sarria,11665,12353,24018
2187,201905,2019,5,Sevilla,507,0,507
2188,201905,2019,5,Tui,2194,6659,8853
2189,201905,2019,5,Valença do Minho,1243,5416,6659
2190,201906,2019,6,Astorga,609,10144,10753
2191,201906,2019,6,Cebreiro,964,11653,12617
2192,201906,2019,6,Ferrol,1839,0,1839
2193,201906,2019,6,Irún,942,0,942
2194,201906,2019,6,Le Puy,472,0,472
2195,201906,2019,6,León,1719,8007,9726
2196,201906,2019,6,Lisboa,443,0,443
2197,201906,2019,6,Lugo - C.P.,546,1450,1996
2198,201906,2019,6,Oporto,4031,0,4031
2199,201906,2019,6,Oporto Costa,1797,443,2240
2200,201906,2019,6,Ourense,483,0,483
2201,201906,2019,6,Oviedo - C.P.,1450,0,1450
2202,201906,2019,6,Pamplona,554,7453,8007
2203,201906,2019,6,Ponferrada,900,10753,11653
2204,201906,2019,6,Resto,8636,0,8636
2205,201906,2019,6,Roncesvalles,875,6578,7453
2206,201906,2019,6,S. Jean P. Port,6106,472,6578
2207,201906,2019,6,Sarria,12915,12617,25532
2208,201906,2019,6,Sevilla,418,0,418
2209,201906,2019,6,Tui,2272,5118,7390
2210,201906,2019,6,Valença do Minho,1087,4031,5118
2211,201907,2019,7,Astorga,1125,5775,6900
2212,201907,2019,7,Cebreiro,1368,8012,9380
2213,201907,2019,7,Ferrol,2454,0,2454
2214,201907,2019,7,Irún,895,0,895
2215,201907,2019,7,León,1284,4491,5775
2216,201907,2019,7,Lugo - C.P.,718,1426,2144
2217,201907,2019,7,Muxia,462,0,462
2218,201907,2019,7,Oporto,2695,0,2695
2219,201907,2019,7,Oporto Costa,1460,0,1460
2220,201907,2019,7,Ourense,1131,0,1131
2221,201907,2019,7,Oviedo - C.P.,1426,0,1426
2222,201907,2019,7,Ponferrada,1112,6900,8012
2223,201907,2019,7,Porriño,452,8846,9298
2224,201907,2019,7,Resto,10731,0,10731
2225,201907,2019,7,Roncesvalles,561,3930,4491
2226,201907,2019,7,S. Jean P. Port,3930,0,3930
2227,201907,2019,7,Sarria,14356,9920,24276
2228,201907,2019,7,Triacastela,540,9380,9920
2229,201907,2019,7,Tui,4442,4404,8846
2230,201907,2019,7,Valença do Minho,1709,2695,4404
2231,201907,2019,7,Vilalba,468,895,1363
2232,201908,2019,8,Astorga,643,6591,7234
2233,201908,2019,8,Cebreiro,1559,8984,10543
2234,201908,2019,8,Ferrol,3554,0,3554
2235,201908,2019,8,Irún,1033,0,1033
2236,201908,2019,8,León,2063,4528,6591
2237,201908,2019,8,Lugo - C.P.,987,2023,3010
2238,201908,2019,8,Oporto,3113,0,3113
2239,201908,2019,8,Oporto Costa,1900,0,1900
2240,201908,2019,8,Ourense,690,0,690
2241,201908,2019,8,Oviedo - C.P.,2023,0,2023
2242,201908,2019,8,Ponferrada,1294,7234,8528
2243,201908,2019,8,Porriño,507,10971,11478
2244,201908,2019,8,Resto,10595,0,10595
2245,201908,2019,8,Roncesvalles,899,3629,4528
2246,201908,2019,8,S. Jean P. Port,3629,0,3629
2247,201908,2019,8,Sarria,18647,11407,30054
2248,201908,2019,8,Triacastela,864,10543,11407
2249,201908,2019,8,Tui,6037,4934,10971
2250,201908,2019,8,Valença do Minho,1821,3113,4934
2251,201908,2019,8,Vigo,500,1900,2400
2252,201908,2019,8,Vilafranca,456,8528,8984
2253,201909,2019,9,Astorga,581,6901,7482
2254,201909,2019,9,Baiona,456,2115,2571
2255,201909,2019,9,Burgos,363,5066,5429
2256,201909,2019,9,Cebreiro,1222,8451,9673
2257,201909,2019,9,Ferrol,1949,0,1949
2258,201909,2019,9,Irún,760,0,760
2259,201909,2019,9,Le Puy,512,0,512
2260,201909,2019,9,León,1472,5429,6901
2261,201909,2019,9,Lugo - C.P.,422,1471,1893
2262,201909,2019,9,Oporto,4078,0,4078
2263,201909,2019,9,Oporto Costa,2115,0,2115
2264,201909,2019,9,Oviedo - C.P.,1471,0,1471
2265,201909,2019,9,Pamplona,341,4725,5066
2266,201909,2019,9,Ponferrada,969,7482,8451
2267,201909,2019,9,Resto,6794,0,6794
2268,201909,2019,9,Roncesvalles,582,4143,4725
2269,201909,2019,9,S. Jean P. Port,3631,512,4143
2270,201909,2019,9,Sarria,13430,9673,23103
2271,201909,2019,9,Tui,2813,5224,8037
2272,201909,2019,9,Valença do Minho,1146,4078,5224
2273,201909,2019,9,Vigo,546,2571,3117
2274,201910,2019,10,Astorga,369,8933,9302
2275,201910,2019,10,Cebreiro,628,9864,10492
2276,201910,2019,10,Ferrol,1218,0,1218
2277,201910,2019,10,Francia - C.F.,265,0,265
2278,201910,2019,10,Irún,787,0,787
2279,201910,2019,10,Le Puy,439,0,439
2280,201910,2019,10,León,1070,7596,8666
2281,201910,2019,10,Lisboa,367,0,367
2282,201910,2019,10,Oporto,3477,0,3477
2283,201910,2019,10,Oporto Costa,1355,367,1722
2284,201910,2019,10,Ourense,346,0,346
2285,201910,2019,10,Oviedo - C.P.,986,0,986
2286,201910,2019,10,Pamplona,379,7217,7596
2287,201910,2019,10,Ponferrada,562,9302,9864
2288,201910,2019,10,Resto,5114,0,5114
2289,201910,2019,10,Roncesvalles,524,6693,7217
2290,201910,2019,10,S. Jean P. Port,5989,704,6693
2291,201910,2019,10,Sarria,9018,10492,19510
2292,201910,2019,10,Sevilla,267,0,267
2293,201910,2019,10,Tui,2034,4401,6435
2294,201910,2019,10,Valença do Minho,924,3477,4401
2295,201911,2019,11,Cebreiro,247,2692,2939
2296,201911,2019,11,Ferrol,316,0,316
2297,201911,2019,11,Francia - C.F.,84,0,84
2298,201911,2019,11,Irún,177,0,177
2299,201911,2019,11,Le Puy,137,0,137
2300,201911,2019,11,León,227,2195,2422
2301,201911,2019,11,Lisboa,76,0,76
2302,201911,2019,11,Lugo - C.P.,72,223,295
2303,201911,2019,11,Oporto,652,0,652
2304,201911,2019,11,Oporto Costa,199,76,275
2305,201911,2019,11,Ourense,77,0,77
2306,201911,2019,11,Oviedo - C.P.,223,0,223
2307,201911,2019,11,Pamplona,97,2098,2195
2308,201911,2019,11,Ponferrada,171,2521,2692
2309,201911,2019,11,Resto,1334,0,1334
2310,201911,2019,11,Roncesvalles,140,1958,2098
2311,201911,2019,11,S. Jean P. Port,1737,221,1958
2312,201911,2019,11,Sarria,1597,2939,4536
2313,201911,2019,11,Sevilla,99,0,99
2314,201911,2019,11,Tui,370,894,1264
2315,201911,2019,11,Valença do Minho,242,652,894
2316,201912,2019,12,Astorga,44,667,711
2317,201912,2019,12,Burgos,27,521,548
2318,201912,2019,12,Cebreiro,73,802,875
2319,201912,2019,12,Ferrol,129,0,129
2320,201912,2019,12,Irún,40,0,40
2321,201912,2019,12,Le Puy,27,0,27
2322,201912,2019,12,León,73,548,621
2323,201912,2019,12,Lisboa,26,0,26
2324,201912,2019,12,Oporto,174,0,174
2325,201912,2019,12,Oporto Costa,60,26,86
2326,201912,2019,12,Oviedo - C.P.,64,0,64
2327,201912,2019,12,Pamplona,55,466,521
2328,201912,2019,12,Ponferrada,91,711,802
2329,201912,2019,12,Resto,515,0,515
2330,201912,2019,12,Roncesvalles,56,410,466
2331,201912,2019,12,S. Jean P. Port,383,27,410
2332,201912,2019,12,Sarria,603,875,1478
2333,201912,2019,12,Sevilla,46,0,46
2334,201912,2019,12,Tui,104,260,364
2335,201912,2019,12,Valença do Minho,86,174,260
2336,201912,2019,12,Vigo,34,86,120
2337,202001,2020,1,Astorga,28,468,496
2338,202001,2020,1,Burgos,22,318,340
2339,202001,2020,1,Cebreiro,42,553,595
2340,202001,2020,1,Ferrol,136,0,136
2341,202001,2020,1,Irún,22,0,22
2342,202001,2020,1,León,128,340,468
2343,202001,2020,1,Lisboa,22,0,22
2344,202001,2020,1,Oporto,210,0,210
2345,202001,2020,1,Oporto Costa,54,22,76
2346,202001,2020,1,Oviedo - C.P.,29,0,29
2347,202001,2020,1,Pamplona,40,278,318
2348,202001,2020,1,Ponferrada,57,496,553
2349,202001,2020,1,Ponferrada. C.Inv.,23,0,23
2350,202001,2020,1,Resto,285,0,285
2351,202001,2020,1,Resto Asturias - C.N,29,0,29
2352,202001,2020,1,Roncesvalles,30,248,278
2353,202001,2020,1,S. Jean P. Port,248,0,248
2354,202001,2020,1,Sarria,428,595,1023
2355,202001,2020,1,Tui,90,272,362
2356,202001,2020,1,Valença do Minho,62,210,272
2357,202001,2020,1,Vigo,16,76,92
2358,202002,2020,2,Astorga,24,553,577
2359,202002,2020,2,Cebreiro,146,615,761
2360,202002,2020,2,Ferrol,178,0,178
2361,202002,2020,2,León,102,417,519
2362,202002,2020,2,Lisboa,46,0,46
2363,202002,2020,2,Monforte de Lemos,23,0,23
2364,202002,2020,2,Oporto,313,0,313
2365,202002,2020,2,Oporto Costa,99,46,145
2366,202002,2020,2,Ourense,23,0,23
2367,202002,2020,2,Oviedo - C.P.,62,0,62
2368,202002,2020,2,Pamplona,44,373,417
2369,202002,2020,2,Ponferrada,38,577,615
2370,202002,2020,2,Ponte de Lima,26,313,339
2371,202002,2020,2,Porriño,33,623,656
2372,202002,2020,2,Resto,416,0,416
2373,202002,2020,2,Roncesvalles,43,330,373
2374,202002,2020,2,S. Jean P. Port,330,0,330
2375,202002,2020,2,Sarria,812,761,1573
2376,202002,2020,2,Sevilla,34,0,34
2377,202002,2020,2,Tui,153,470,623
2378,202002,2020,2,Valença do Minho,131,339,470
2379,202003,2020,3,Baiona,21,64,85
2380,202003,2020,3,Burgos,21,181,202
2381,202003,2020,3,Cebreiro,34,304,338
2382,202003,2020,3,Ferrol,102,0,102
2383,202003,2020,3,León,49,202,251
2384,202003,2020,3,Lisboa,24,0,24
2385,202003,2020,3,Lugo - C.P.,31,31,62
2386,202003,2020,3,Oporto,280,0,280
2387,202003,2020,3,Oporto Costa,40,24,64
2388,202003,2020,3,Ourense,34,0,34
2389,202003,2020,3,Oviedo - C.P.,31,0,31
2390,202003,2020,3,Pamplona,17,164,181
2391,202003,2020,3,Ponferrada,38,266,304
2392,202003,2020,3,Resto,220,0,220
2393,202003,2020,3,Roncesvalles,31,133,164
2394,202003,2020,3,S. Jean P. Port,133,0,133
2395,202003,2020,3,Sarria,654,372,1026
2396,202003,2020,3,Sevilla,15,0,15
2397,202003,2020,3,Triacastela,34,338,372
2398,202003,2020,3,Tui,78,341,419
2399,202003,2020,3,Valença do Minho,61,280,341
2400,202006,2020,6,Baiona,1,0,1
2401,202006,2020,6,Ferrol,4,0,4
2402,202006,2020,6,Gijón,1,0,1
2403,202006,2020,6,Lugo - C.P.,1,0,1
2404,202006,2020,6,Sarria,5,0,5
2405,202007,2020,7,A Guarda,104,155,259
2406,202007,2020,7,Astorga,112,819,931
2407,202007,2020,7,Burgos,75,456,531
2408,202007,2020,7,Cebreiro,286,1322,1608
2409,202007,2020,7,Ferrol,691,0,691
2410,202007,2020,7,Irún,84,0,84
2411,202007,2020,7,León,288,531,819
2412,202007,2020,7,Lugo - C.P.,168,406,574
2413,202007,2020,7,Oporto,386,0,386
2414,202007,2020,7,Oporto Costa,155,0,155
2415,202007,2020,7,Ourense,127,0,127
2416,202007,2020,7,Oviedo - C.P.,406,0,406
2417,202007,2020,7,Ponferrada,313,931,1244
2418,202007,2020,7,Resto,1638,0,1638
2419,202007,2020,7,Roncesvalles,212,244,456
2420,202007,2020,7,S. Jean P. Port,244,0,244
2421,202007,2020,7,Sarria,3196,1608,4804
2422,202007,2020,7,Tui,923,553,1476
2423,202007,2020,7,Valença do Minho,167,386,553
2424,202007,2020,7,Vigo,99,259,358
2425,202007,2020,7,Vilafranca,78,1244,1322
2426,202008,2020,8,A Guarda,178,315,493
2427,202008,2020,8,Astorga,256,1764,2020
2428,202008,2020,8,Baiona,222,493,715
2429,202008,2020,8,Cebreiro,520,2709,3229
2430,202008,2020,8,Ferrol,945,0,945
2431,202008,2020,8,Irún,368,0,368
2432,202008,2020,8,León,585,1179,1764
2433,202008,2020,8,Lugo - C.P.,351,790,1141
2434,202008,2020,8,Oporto,830,0,830
2435,202008,2020,8,Oporto Costa,315,0,315
2436,202008,2020,8,Oviedo - C.P.,790,0,790
2437,202008,2020,8,Ponferrada,532,2020,2552
2438,202008,2020,8,Resto,4468,0,4468
2439,202008,2020,8,Ribadeo,192,368,560
2440,202008,2020,8,Roncesvalles,347,832,1179
2441,202008,2020,8,S. Jean P. Port,832,0,832
2442,202008,2020,8,Sarria,5701,3229,8930
2443,202008,2020,8,Tui,1690,1204,2894
2444,202008,2020,8,Valença do Minho,374,830,1204
2445,202008,2020,8,Vigo,159,715,874
2446,202008,2020,8,Vilafranca,157,2552,2709
2447,202009,2020,9,Astorga,123,1347,1470
2448,202009,2020,9,Baiona,91,206,297
2449,202009,2020,9,Burgos,82,1010,1092
2450,202009,2020,9,Cebreiro,284,1855,2139
2451,202009,2020,9,Ferrol,525,0,525
2452,202009,2020,9,Irún,206,0,206
2453,202009,2020,9,Le Puy,115,0,115
2454,202009,2020,9,León,255,1092,1347
2455,202009,2020,9,Lugo - C.P.,126,511,637
2456,202009,2020,9,Oporto,640,0,640
2457,202009,2020,9,Oporto Costa,206,0,206
2458,202009,2020,9,Oviedo - C.P.,511,0,511
2459,202009,2020,9,Pamplona,77,933,1010
2460,202009,2020,9,Ponferrada,292,1470,1762
2461,202009,2020,9,Resto,2184,0,2184
2462,202009,2020,9,Roncesvalles,235,698,933
2463,202009,2020,9,S. Jean P. Port,583,115,698
2464,202009,2020,9,Sarria,2713,2139,4852
2465,202009,2020,9,Tui,840,900,1740
2466,202009,2020,9,Valença do Minho,260,640,900
2467,202009,2020,9,Vilafranca,93,1762,1855
2468,202010,2020,10,Astorga,82,1266,1348
2469,202010,2020,10,Cebreiro,169,1493,1662
2470,202010,2020,10,Ferrol,259,0,259
2471,202010,2020,10,Francia - C.F.,85,0,85
2472,202010,2020,10,Irún,125,0,125
2473,202010,2020,10,Le Puy,136,0,136
2474,202010,2020,10,León,128,1070,1198
2475,202010,2020,10,Lisboa,94,0,94
2476,202010,2020,10,Lugo - C.P.,64,267,331
2477,202010,2020,10,Oporto,483,0,483
2478,202010,2020,10,Oporto Costa,117,94,211
2479,202010,2020,10,Oviedo - C.P.,267,0,267
2480,202010,2020,10,Pamplona,63,1007,1070
2481,202010,2020,10,Ponferrada,145,1348,1493
2482,202010,2020,10,Resto,1408,0,1408
2483,202010,2020,10,Roncesvalles,173,834,1007
2484,202010,2020,10,S. Jean P. Port,613,221,834
2485,202010,2020,10,Sarria,1335,1662,2997
2486,202010,2020,10,Sevilla,68,0,68
2487,202010,2020,10,Tui,375,712,1087
2488,202010,2020,10,Valença do Minho,229,483,712
2489,202011,2020,11,Alemania,5,0,5
2490,202011,2020,11,Astorga,7,319,326
2491,202011,2020,11,Cebreiro,7,332,339
2492,202011,2020,11,Ferrol,8,0,8
2493,202011,2020,11,Francia - C.F.,23,0,23
2494,202011,2020,11,Irún,22,0,22
2495,202011,2020,11,Le Puy,50,5,55
2496,202011,2020,11,Lisboa,16,0,16
2497,202011,2020,11,Lourdes,5,0,5
2498,202011,2020,11,Madrid - C.F.,7,0,7
2499,202011,2020,11,Oporto,24,0,24
2500,202011,2020,11,Oviedo - C.P.,13,0,13
2501,202011,2020,11,Pamplona,33,261,294
2502,202011,2020,11,Resto,127,0,127
2503,202011,2020,11,Roncesvalles,31,230,261
2504,202011,2020,11,S. Jean P. Port,147,83,230
2505,202011,2020,11,San Sebastián,5,22,27
2506,202011,2020,11,Santander,6,27,33
2507,202011,2020,11,Sarria,25,339,364
2508,202011,2020,11,Sevilla,18,0,18
2509,202011,2020,11,Vilafranca,6,326,332
2510,202012,2020,12,Alemania,1,0,1
2511,202012,2020,12,Bélgica,1,0,1
2512,202012,2020,12,Cebreiro,6,18,24
2513,202012,2020,12,Com. Valenciana - O.C.,1,0,1
2514,202012,2020,12,Francia - C.F.,3,1,4
2515,202012,2020,12,Gudiña,12,1,13
2516,202012,2020,12,León,2,7,9
2517,202012,2020,12,Lisboa,4,0,4
2518,202012,2020,12,Oporto,21,1,22
2519,202012,2020,12,Ourense,3,13,16
2520,202012,2020,12,Ponferrada. C.Inv.,2,0,2
2521,202012,2020,12,Resto,8,0,8
2522,202012,2020,12,Resto de Galicia,1,0,1
2523,202012,2020,12,Resto de Portugal,1,0,1
2524,202012,2020,12,S. Jean P. Port,1,6,7
2525,202012,2020,12,Sarria,10,25,35
2526,202012,2020,12,Sevilla,5,0,5
2527,202012,2020,12,Tui,8,26,34
2528,202012,2020,12,Valença do Minho,4,22,26
2529,202012,2020,12,Vega de Valcarce,4,14,18
2530,202012,2020,12,Vezelay,1,1,2
2531,202101,2021,1,Alemania,2,0,2
2532,202101,2021,1,Astorga,1,9,10
2533,202101,2021,1,Cebreiro,6,11,17
2534,202101,2021,1,Ferrol,5,0,5
2535,202101,2021,1,Fonsagrada - C.P.,1,2,3
2536,202101,2021,1,Irún,1,0,1
2537,202101,2021,1,Laza,1,0,1
2538,202101,2021,1,Lisboa,2,0,2
2539,202101,2021,1,Oporto,9,0,9
2540,202101,2021,1,Oporto Costa,1,2,3
2541,202101,2021,1,Oviedo - C.P.,2,0,2
2542,202101,2021,1,Resto,6,0,6
2543,202101,2021,1,S. Jean P. Port,5,2,7
2544,202101,2021,1,Sahagún,1,7,8
2545,202101,2021,1,San Sebastián,1,1,2
2546,202101,2021,1,Sarria,10,17,27
2547,202101,2021,1,Sevilla,1,0,1
2548,202101,2021,1,Tui,2,10,12
2549,202101,2021,1,Valença do Minho,1,9,10
2550,202101,2021,1,Vigo,1,3,4
2551,202101,2021,1,Vilafranca,1,10,11
2552,202102,2021,2,Cebreiro,1,4,5
2553,202102,2021,2,Francia - C.F.,1,0,1
2554,202102,2021,2,Le Puy,1,1,2
2555,202102,2021,2,Lisboa,3,0,3
2556,202102,2021,2,Oviedo - C.P.,2,0,2
2557,202102,2021,2,Republica Checa,1,0,1
2558,202102,2021,2,S. Jean P. Port,1,3,4
2559,202102,2021,2,Sarria,4,5,9
2560,202103,2021,3,A Coruña,4,0,4
2561,202103,2021,3,A Guarda,2,2,4
2562,202103,2021,3,Cebreiro,31,13,44
2563,202103,2021,3,Ferrol,25,0,25
2564,202103,2021,3,Francia - C.F.,2,0,2
2565,202103,2021,3,León,2,5,7
2566,202103,2021,3,Lisboa,2,0,2
2567,202103,2021,3,Lugo - C.P.,5,5,10
2568,202103,2021,3,Madrid - C.F.,2,0,2
2569,202103,2021,3,Monforte de Lemos,2,2,4
2570,202103,2021,3,Montserrat,1,0,1
2571,202103,2021,3,O Barco de Valdeorras,1,1,2
2572,202103,2021,3,Ourense,3,0,3
2573,202103,2021,3,Oviedo - C.P.,5,0,5
2574,202103,2021,3,Ponferrada,4,9,13
2575,202103,2021,3,Ponferrada. C.Inv.,1,0,1
2576,202103,2021,3,Resto,12,0,12
2577,202103,2021,3,Sarria,70,44,114
2578,202103,2021,3,Sevilla,2,0,2
2579,202103,2021,3,Tui,12,0,12
2580,202103,2021,3,Vigo,6,4,10
2581,202104,2021,4,A Coruña,11,0,11
2582,202104,2021,4,Burgos,7,17,24
2583,202104,2021,4,Cebreiro,138,50,188
2584,202104,2021,4,Ferrol,67,0,67
2585,202104,2021,4,Finisterra,13,0,13
2586,202104,2021,4,Fonsagrada - C.P.,16,12,28
2587,202104,2021,4,León,14,24,38
2588,202104,2021,4,Lugo - C.P.,30,28,58
2589,202104,2021,4,Oporto,17,0,17
2590,202104,2021,4,Ourense,51,0,51
2591,202104,2021,4,Oviedo - C.P.,12,0,12
2592,202104,2021,4,Pamplona,10,7,17
2593,202104,2021,4,Ponferrada,12,38,50
2594,202104,2021,4,Resto,125,0,125
2595,202104,2021,4,S. Jean P. Port,7,0,7
2596,202104,2021,4,Samos,7,0,7
2597,202104,2021,4,Sarria,287,202,489
2598,202104,2021,4,Triacastela,7,188,195
2599,202104,2021,4,Tui,155,27,182
2600,202104,2021,4,Valença do Minho,10,17,27
2601,202104,2021,4,Vigo,28,0,28
2602,202105,2021,5,A Guarda,39,39,78
2603,202105,2021,5,Astorga,40,295,335
2604,202105,2021,5,Cebreiro,226,414,640
2605,202105,2021,5,Ferrol,334,0,334
2606,202105,2021,5,Irún,47,0,47
2607,202105,2021,5,León,100,195,295
2608,202105,2021,5,Lugo - C.P.,95,136,231
2609,202105,2021,5,Madrid - C.F.,47,0,47
2610,202105,2021,5,Oporto,194,0,194
2611,202105,2021,5,Oporto Costa,39,0,39
2612,202105,2021,5,Ourense,52,42,94
2613,202105,2021,5,Oviedo - C.P.,136,0,136
2614,202105,2021,5,Ponferrada,79,335,414
2615,202105,2021,5,Ponte de Lima,48,194,242
2616,202105,2021,5,Resto,926,0,926
2617,202105,2021,5,Roncesvalles,81,67,148
2618,202105,2021,5,S. Jean P. Port,67,0,67
2619,202105,2021,5,Sarria,1289,640,1929
2620,202105,2021,5,Tui,272,384,656
2621,202105,2021,5,Valença do Minho,142,242,384
2622,202105,2021,5,Verín,42,0,42
2623,202106,2021,6,Astorga,171,1652,1823
2624,202106,2021,6,Barcelona,229,0,229
2625,202106,2021,6,Cebreiro,412,2066,2478
2626,202106,2021,6,Com. Valenciana - C.F.,108,0,108
2627,202106,2021,6,Ferrol,707,0,707
2628,202106,2021,6,Irún,172,0,172
2629,202106,2021,6,León,382,1270,1652
2630,202106,2021,6,Lugo - C.P.,182,463,645
2631,202106,2021,6,Madrid - C.F.,135,0,135
2632,202106,2021,6,Oporto,811,0,811
2633,202106,2021,6,Oporto Costa,168,0,168
2634,202106,2021,6,Ourense,131,0,131
2635,202106,2021,6,Oviedo - C.P.,463,0,463
2636,202106,2021,6,Pamplona,124,674,798
2637,202106,2021,6,Ponferrada,243,1823,2066
2638,202106,2021,6,Resto,3294,0,3294
2639,202106,2021,6,Roncesvalles,315,359,674
2640,202106,2021,6,S. Jean P. Port,359,0,359
2641,202106,2021,6,Sarria,4708,2478,7186
2642,202106,2021,6,Tui,1140,1381,2521
2643,202106,2021,6,Valença do Minho,570,811,1381
2644,202107,2021,7,A Guarda,392,336,728
2645,202107,2021,7,Astorga,389,2165,2554
2646,202107,2021,7,Cebreiro,936,3794,4730
2647,202107,2021,7,Ferrol,2101,0,2101
2648,202107,2021,7,Irún,395,0,395
2649,202107,2021,7,León,717,1448,2165
2650,202107,2021,7,Lugo - C.P.,722,1024,1746
2651,202107,2021,7,Oporto,1126,0,1126
2652,202107,2021,7,Oporto Costa,336,0,336
2653,202107,2021,7,Ourense,310,0,310
2654,202107,2021,7,Oviedo - C.P.,1024,0,1024
2655,202107,2021,7,Ponferrada,922,2554,3476
2656,202107,2021,7,Resto,7161,0,7161
2657,202107,2021,7,Ribadeo,305,395,700
2658,202107,2021,7,Roncesvalles,513,935,1448
2659,202107,2021,7,S. Jean P. Port,935,0,935
2660,202107,2021,7,Sarria,11243,4730,15973
2661,202107,2021,7,Tui,3151,1747,4898
2662,202107,2021,7,Valença do Minho,621,1126,1747
2663,202107,2021,7,Vigo,346,728,1074
2664,202107,2021,7,Vilafranca,318,3476,3794
2665,202108,2021,8,Astorga,383,3426,3809
2666,202108,2021,8,Baiona,397,474,871
2667,202108,2021,8,Cebreiro,1027,4701,5728
2668,202108,2021,8,Com. Valenciana - C.F.,435,0,435
2669,202108,2021,8,Ferrol,2959,0,2959
2670,202108,2021,8,Irún,474,0,474
2671,202108,2021,8,León,968,2458,3426
2672,202108,2021,8,Lugo - C.P.,795,1365,2160
2673,202108,2021,8,Oporto,1318,0,1318
2674,202108,2021,8,Oporto Costa,474,0,474
2675,202108,2021,8,Ourense,365,0,365
2676,202108,2021,8,Oviedo - C.P.,1365,0,1365
2677,202108,2021,8,Ponferrada,892,3809,4701
2678,202108,2021,8,Resto,8226,0,8226
2679,202108,2021,8,Ribadeo,385,474,859
2680,202108,2021,8,Roncesvalles,680,1343,2023
2681,202108,2021,8,S. Jean P. Port,1343,0,1343
2682,202108,2021,8,Sarria,15201,5728,20929
2683,202108,2021,8,Tui,4463,2348,6811
2684,202108,2021,8,Valença do Minho,1030,1318,2348
2685,202108,2021,8,Vigo,395,871,1266
2686,202109,2021,9,Astorga,447,4169,4616
2687,202109,2021,9,Barcelona,312,0,312
2688,202109,2021,9,Cebreiro,1057,5292,6349
2689,202109,2021,9,Ferrol,1995,0,1995
2690,202109,2021,9,Irún,447,0,447
2691,202109,2021,9,Le Puy,378,0,378
2692,202109,2021,9,León,900,3269,4169
2693,202109,2021,9,Lugo - C.P.,444,1367,1811
2694,202109,2021,9,Madrid - C.F.,316,0,316
2695,202109,2021,9,Oporto,2282,0,2282
2696,202109,2021,9,Oporto Costa,617,0,617
2697,202109,2021,9,Oviedo - C.P.,1367,0,1367
2698,202109,2021,9,Ponferrada,676,4616,5292
2699,202109,2021,9,Resto,7402,0,7402
2700,202109,2021,9,Resto Galicia,341,0,341
2701,202109,2021,9,Roncesvalles,599,2042,2641
2702,202109,2021,9,S. Jean P. Port,1664,378,2042
2703,202109,2021,9,Sarria,11878,6690,18568
2704,202109,2021,9,Tui,2989,3304,6293
2705,202109,2021,9,Valença do Minho,1022,2282,3304
2706,202109,2021,9,Vigo,330,617,947
2707,202110,2021,10,Astorga,308,4937,5245
2708,202110,2021,10,Cebreiro,690,5896,6586
2709,202110,2021,10,Ferrol,1568,0,1568
2710,202110,2021,10,Irún,481,0,481
2711,202110,2021,10,Le Puy,354,0,354
2712,202110,2021,10,León,677,3994,4671
2713,202110,2021,10,Lugo - C.P.,307,1115,1422
2714,202110,2021,10,Oporto,2193,0,2193
2715,202110,2021,10,Oporto Costa,615,0,615
2716,202110,2021,10,Ourense,309,0,309
2717,202110,2021,10,Oviedo - C.P.,1115,0,1115
2718,202110,2021,10,Pamplona,310,3684,3994
2719,202110,2021,10,Ponferrada,651,5245,5896
2720,202110,2021,10,Resto,6451,0,6451
2721,202110,2021,10,Roncesvalles,625,3059,3684
2722,202110,2021,10,S. Jean P. Port,2705,354,3059
2723,202110,2021,10,Sarria,8047,6586,14633
2724,202110,2021,10,Sevilla,266,0,266
2725,202110,2021,10,Tui,2155,3274,5429
2726,202110,2021,10,Valença do Minho,1081,2193,3274
2727,202110,2021,10,Vigo,262,615,877
2728,202111,2021,11,A Guarda,84,206,290
2729,202111,2021,11,Cebreiro,301,1817,2118
2730,202111,2021,11,Ferrol,629,0,629
2731,202111,2021,11,Francia - C.F.,109,0,109
2732,202111,2021,11,Irún,139,0,139
2733,202111,2021,11,Le Puy,129,0,129
2734,202111,2021,11,León,178,1399,1577
2735,202111,2021,11,Lugo - C.P.,127,241,368
2736,202111,2021,11,Oporto,617,0,617
2737,202111,2021,11,Oporto Costa,206,0,206
2738,202111,2021,11,Ourense,120,0,120
2739,202111,2021,11,Oviedo - C.P.,241,0,241
2740,202111,2021,11,Pamplona,110,1289,1399
2741,202111,2021,11,Ponferrada,153,1664,1817
2742,202111,2021,11,Resto,1904,0,1904
2743,202111,2021,11,Roncesvalles,174,1115,1289
2744,202111,2021,11,S. Jean P. Port,877,238,1115
2745,202111,2021,11,Sarria,2055,2118,4173
2746,202111,2021,11,Sevilla,87,0,87
2747,202111,2021,11,Tui,544,927,1471
2748,202111,2021,11,Valença do Minho,310,617,927
2749,202112,2021,12,A Guarda,11,16,27
2750,202112,2021,12,Astorga,11,178,189
2751,202112,2021,12,Cebreiro,56,204,260
2752,202112,2021,12,Ferrol,64,0,64
2753,202112,2021,12,Francia - C.F.,14,0,14
2754,202112,2021,12,Le Puy,28,0,28
2755,202112,2021,12,León,14,164,178
2756,202112,2021,12,Lisboa,16,0,16
2757,202112,2021,12,Lugo - C.P.,20,22,42
2758,202112,2021,12,Oporto,49,0,49
2759,202112,2021,12,Ourense,27,0,27
2760,202112,2021,12,Oviedo - C.P.,22,0,22
2761,202112,2021,12,Pamplona,21,143,164
2762,202112,2021,12,Ponferrada,15,189,204
2763,202112,2021,12,Resto,193,0,193
2764,202112,2021,12,Roncesvalles,20,123,143
2765,202112,2021,12,S. Jean P. Port,81,42,123
2766,202112,2021,12,Sarria,371,260,631
2767,202112,2021,12,Tui,108,82,190
2768,202112,2021,12,Valença do Minho,33,49,82
2769,202112,2021,12,Vigo,19,27,46
2770,202201,2022,1,A Guarda,16,37,53
2771,202201,2022,1,Cebreiro,82,228,310
2772,202201,2022,1,Ferrol,114,0,114
2773,202201,2022,1,León,57,116,173
2774,202201,2022,1,Lisboa,16,0,16
2775,202201,2022,1,Mérida,18,0,18
2776,202201,2022,1,Oporto,107,0,107
2777,202201,2022,1,Oporto Costa,21,16,37
2778,202201,2022,1,Ourense,18,0,18
2779,202201,2022,1,Oviedo - C.P.,37,0,37
2780,202201,2022,1,Pamplona,21,95,116
2781,202201,2022,1,Ponferrada,37,191,228
2782,202201,2022,1,Ponferrada. C.Inv.,32,0,32
2783,202201,2022,1,Resto,249,0,249
2784,202201,2022,1,Resto Galicia,24,0,24
2785,202201,2022,1,Roncesvalles,13,82,95
2786,202201,2022,1,S. Jean P. Port,82,0,82
2787,202201,2022,1,Sarria,474,334,808
2788,202201,2022,1,Tui,113,163,276
2789,202201,2022,1,Valença do Minho,56,107,163
2790,202201,2022,1,Vigo,30,53,83
2791,202202,2022,2,Cebreiro,54,279,333
2792,202202,2022,2,Ferrol,106,0,106
2793,202202,2022,2,Fonsagrada - C.P.,113,38,151
2794,202202,2022,2,León,46,166,212
2795,202202,2022,2,Lisboa,32,0,32
2796,202202,2022,2,Lugo - C.P.,27,151,178
2797,202202,2022,2,Oporto,159,19,178
2798,202202,2022,2,Oporto Costa,24,32,56
2799,202202,2022,2,Ourense,21,0,21
2800,202202,2022,2,Oviedo - C.P.,38,0,38
2801,202202,2022,2,Pamplona,32,134,166
2802,202202,2022,2,Ponferrada,36,243,279
2803,202202,2022,2,Ponferrada. C.Inv.,28,0,28
2804,202202,2022,2,Resto,355,0,355
2805,202202,2022,2,Resto Portugal,19,0,19
2806,202202,2022,2,Roncesvalles,45,89,134
2807,202202,2022,2,S. Jean P. Port,89,0,89
2808,202202,2022,2,Sarria,473,333,806
2809,202202,2022,2,Sevilla,31,0,31
2810,202202,2022,2,Tui,175,309,484
2811,202202,2022,2,Valença do Minho,131,178,309
2812,202203,2022,3,Burgos,51,290,341
2813,202203,2022,3,Cebreiro,209,667,876
2814,202203,2022,3,Ferrol,368,0,368
2815,202203,2022,3,León,137,341,478
2816,202203,2022,3,Lisboa,89,0,89
2817,202203,2022,3,Lugo - C.P.,80,166,246
2818,202203,2022,3,Oporto,881,0,881
2819,202203,2022,3,Oporto Costa,175,89,264
2820,202203,2022,3,Oviedo - C.P.,166,0,166
2821,202203,2022,3,Pamplona,52,238,290
2822,202203,2022,3,Ponferrada,123,544,667
2823,202203,2022,3,Ponte de Lima,59,881,940
2824,202203,2022,3,Resto,1060,0,1060
2825,202203,2022,3,Resto Galicia,68,0,68
2826,202203,2022,3,Roncesvalles,59,179,238
2827,202203,2022,3,S. Jean P. Port,179,0,179
2828,202203,2022,3,Sarria,2741,944,3685
2829,202203,2022,3,Sevilla,66,0,66
2830,202203,2022,3,Tui,458,1212,1670
2831,202203,2022,3,Valença do Minho,272,940,1212
2832,202203,2022,3,Vigo,96,264,360
2833,202204,2022,4,Cebreiro,725,2827,3552
2834,202204,2022,4,Ferrol,1682,0,1682
2835,202204,2022,4,Irún,255,0,255
2836,202204,2022,4,León,453,1965,2418
2837,202204,2022,4,Lugo - C.P.,484,535,1019
2838,202204,2022,4,Madrid - C.F.,446,0,446
2839,202204,2022,4,Oporto,2774,0,2774
2840,202204,2022,4,Oporto Costa,600,0,600
2841,202204,2022,4,Ourense,563,0,563
2842,202204,2022,4,Oviedo - C.P.,535,0,535
2843,202204,2022,4,Ponferrada,409,2418,2827
2844,202204,2022,4,Ponte de Lima,265,2774,3039
2845,202204,2022,4,Porriño,485,7084,7569
2846,202204,2022,4,Resto,6085,0,6085
2847,202204,2022,4,Resto de Galicia,239,0,239
2848,202204,2022,4,Roncesvalles,425,1094,1519
2849,202204,2022,4,S. Jean P. Port,1094,0,1094
2850,202204,2022,4,Sarria,12278,3791,16069
2851,202204,2022,4,Tui,2665,4419,7084
2852,202204,2022,4,Valença do Minho,1380,3039,4419
2853,202204,2022,4,Vigo,441,600,1041
2854,202205,2022,5,Astorga,495,7607,8102
2855,202205,2022,5,Baiona,516,1209,1725
2856,202205,2022,5,Cebreiro,795,8813,9608
2857,202205,2022,5,Ferrol,2288,0,2288
2858,202205,2022,5,Irún,640,0,640
2859,202205,2022,5,Le Puy,475,0,475
2860,202205,2022,5,León,1158,5981,7139
2861,202205,2022,5,Lugo - C.P.,791,1301,2092
2862,202205,2022,5,Oporto,5047,0,5047
2863,202205,2022,5,Oporto Costa,1209,0,1209
2864,202205,2022,5,Oviedo - C.P.,1301,0,1301
2865,202205,2022,5,Pamplona,467,5514,5981
2866,202205,2022,5,Ponferrada,711,8102,8813
2867,202205,2022,5,Resto,9254,0,9254
2868,202205,2022,5,Roncesvalles,735,4779,5514
2869,202205,2022,5,S. Jean P. Port,4304,475,4779
2870,202205,2022,5,Sarria,12982,9608,22590
2871,202205,2022,5,Sevilla,468,0,468
2872,202205,2022,5,Tui,2896,6213,9109
2873,202205,2022,5,Valença do Minho,1166,5047,6213
2874,202205,2022,5,Vigo,556,1725,2281
2875,202206,2022,6,Astorga,442,7798,8240
2876,202206,2022,6,Baiona,550,1740,2290
2877,202206,2022,6,Cebreiro,1069,9002,10071
2878,202206,2022,6,Ferrol,2291,0,2291
2879,202206,2022,6,Irún,988,0,988
2880,202206,2022,6,Le Puy,604,0,604
2881,202206,2022,6,León,1241,6557,7798
2882,202206,2022,6,Lisboa,426,0,426
2883,202206,2022,6,Lugo - C.P.,605,1617,2222
2884,202206,2022,6,Oporto,4577,0,4577
2885,202206,2022,6,Oporto Costa,1314,426,1740
2886,202206,2022,6,Ourense,419,0,419
2887,202206,2022,6,Oviedo - C.P.,1617,0,1617
2888,202206,2022,6,Ponferrada,762,8240,9002
2889,202206,2022,6,Resto,12139,0,12139
2890,202206,2022,6,Roncesvalles,855,5702,6557
2891,202206,2022,6,S. Jean P. Port,5098,604,5702
2892,202206,2022,6,Sarria,16948,10071,27019
2893,202206,2022,6,Tui,3571,6233,9804
2894,202206,2022,6,Valença do Minho,1656,4577,6233
2895,202206,2022,6,Vigo,840,2290,3130
2896,202207,2022,7,Astorga,856,5169,6025
2897,202207,2022,7,Baiona,763,1109,1872
2898,202207,2022,7,Cebreiro,1312,7086,8398
2899,202207,2022,7,Ferrol,3585,0,3585
2900,202207,2022,7,Irún,945,0,945
2901,202207,2022,7,León,1105,4064,5169
2902,202207,2022,7,Lugo - C.P.,1091,1654,2745
2903,202207,2022,7,Oporto,3103,0,3103
2904,202207,2022,7,Oporto Costa,1109,0,1109
2905,202207,2022,7,Ourense,969,0,969
2906,202207,2022,7,Oviedo - C.P.,1654,0,1654
2907,202207,2022,7,Ponferrada,1061,6025,7086
2908,202207,2022,7,Porriño,798,10875,11673
2909,202207,2022,7,Resto,14625,0,14625
2910,202207,2022,7,Roncesvalles,673,3391,4064
2911,202207,2022,7,S. Jean P. Port,3391,0,3391
2912,202207,2022,7,Sarria,20541,9155,29696
2913,202207,2022,7,Triacastela,757,8398,9155
2914,202207,2022,7,Tui,6317,4558,10875
2915,202207,2022,7,Valença do Minho,1455,3103,4558
2916,202207,2022,7,Vigo,1264,1872,3136
2917,202208,2022,8,Astorga,609,4962,5571
2918,202208,2022,8,Baiona,996,1298,2294
2919,202208,2022,8,Cebreiro,1548,6652,8200
2920,202208,2022,8,Ferrol,6389,0,6389
2921,202208,2022,8,Irún,856,0,856
2922,202208,2022,8,León,1363,3599,4962
2923,202208,2022,8,Lugo - C.P.,2245,2280,4525
2924,202208,2022,8,Oporto,3849,0,3849
2925,202208,2022,8,Oporto Costa,1298,0,1298
2926,202208,2022,8,Ourense,1697,0,1697
2927,202208,2022,8,Oviedo - C.P.,2280,0,2280
2928,202208,2022,8,Ponferrada,1081,5571,6652
2929,202208,2022,8,Porriño,1386,14110,15496
2930,202208,2022,8,Resto,16171,0,16171
2931,202208,2022,8,Roncesvalles,816,2783,3599
2932,202208,2022,8,S. Jean P. Port,2783,0,2783
2933,202208,2022,8,Sarria,27123,8200,35323
2934,202208,2022,8,Tui,8438,5672,14110
2935,202208,2022,8,Valença do Minho,1823,3849,5672
2936,202208,2022,8,Vigo,2212,2294,4506
2937,202208,2022,8,Vilalba,879,856,1735
2938,202209,2022,9,Astorga,538,6555,7093
2939,202209,2022,9,Baiona,890,1640,2530
2940,202209,2022,9,Burgos,466,4611,5077
2941,202209,2022,9,Cebreiro,1172,8086,9258
2942,202209,2022,9,Ferrol,3392,0,3392
2943,202209,2022,9,Irún,675,0,675
2944,202209,2022,9,Le Puy,540,0,540
2945,202209,2022,9,León,1478,5077,6555
2946,202209,2022,9,Lugo - C.P.,840,1841,2681
2947,202209,2022,9,Oporto,5736,0,5736
2948,202209,2022,9,Oporto Costa,1640,0,1640
2949,202209,2022,9,Ourense,587,0,587
2950,202209,2022,9,Oviedo - C.P.,1841,0,1841
2951,202209,2022,9,Ponferrada,993,7093,8086
2952,202209,2022,9,Resto,12306,0,12306
2953,202209,2022,9,Roncesvalles,707,3904,4611
2954,202209,2022,9,S. Jean P. Port,3364,540,3904
2955,202209,2022,9,Sarria,20628,9258,29886
2956,202209,2022,9,Tui,5255,7590,12845
2957,202209,2022,9,Valença do Minho,1854,5736,7590
2958,202209,2022,9,Vigo,1294,2530,3824
2959,202210,2022,10,Baiona,576,1881,2457
2960,202210,2022,10,Cebreiro,742,9253,9995
2961,202210,2022,10,Ferrol,1912,0,1912
2962,202210,2022,10,Irún,833,0,833
2963,202210,2022,10,Le Puy,529,0,529
2964,202210,2022,10,León,985,7597,8582
2965,202210,2022,10,Lisboa,469,0,469
2966,202210,2022,10,Lugo - C.P.,502,1319,1821
2967,202210,2022,10,Oporto,4612,0,4612
2968,202210,2022,10,Oporto Costa,1412,469,1881
2969,202210,2022,10,Ourense,377,0,377
2970,202210,2022,10,Oviedo - C.P.,1319,0,1319
2971,202210,2022,10,Pamplona,441,7156,7597
2972,202210,2022,10,Ponferrada,671,8582,9253
2973,202210,2022,10,Resto,9401,0,9401
2974,202210,2022,10,Roncesvalles,945,6211,7156
2975,202210,2022,10,S. Jean P. Port,5682,529,6211
2976,202210,2022,10,Sarria,14497,9995,24492
2977,202210,2022,10,Tui,2906,6337,9243
2978,202210,2022,10,Valença do Minho,1725,4612,6337
2979,202210,2022,10,Vigo,820,2457,3277
2980,202211,2022,11,Cebreiro,316,2658,2974
2981,202211,2022,11,Ferrol,487,0,487
2982,202211,2022,11,Irún,203,0,203
2983,202211,2022,11,Le Puy,174,0,174
2984,202211,2022,11,León,216,2264,2480
2985,202211,2022,11,Madrid - C.F.,169,0,169
2986,202211,2022,11,Oporto,759,0,759
2987,202211,2022,11,Oporto Costa,247,0,247
2988,202211,2022,11,Ourense,376,0,376
2989,202211,2022,11,Oviedo - C.P.,281,0,281
2990,202211,2022,11,Pamplona,143,1952,2095
2991,202211,2022,11,Ponferrada,178,2480,2658
2992,202211,2022,11,Ponferrada. C.Inv.,189,0,189
2993,202211,2022,11,Ponte de sa,150,203,353
2994,202211,2022,11,Resto,2350,0,2350
2995,202211,2022,11,Roncesvalles,172,1780,1952
2996,202211,2022,11,S. Jean P. Port,1606,174,1780
2997,202211,2022,11,Sarria,2333,2974,5307
2998,202211,2022,11,Tui,503,1050,1553
2999,202211,2022,11,Valença do Minho,291,759,1050
3000,202211,2022,11,Vigo,140,247,387
3001,202212,2022,12,A Guarda,67,142,209
3002,202212,2022,12,Cebreiro,217,625,842
3003,202212,2022,12,Corrubedo,65,0,65
3004,202212,2022,12,Ferrol,328,0,328
3005,202212,2022,12,Le Puy,52,0,52
3006,202212,2022,12,León,67,497,564
3007,202212,2022,12,Lisboa,69,0,69
3008,202212,2022,12,Lugo - C.P.,51,82,133
3009,202212,2022,12,Oporto,238,0,238
3010,202212,2022,12,Oporto Costa,73,69,142
3011,202212,2022,12,Ourense,70,0,70
3012,202212,2022,12,Oviedo - C.P.,82,0,82
3013,202212,2022,12,Ponferrada,61,564,625
3014,202212,2022,12,Resto,980,0,980
3015,202212,2022,12,Ribadeo,147,0,147
3016,202212,2022,12,Roncesvalles,94,403,497
3017,202212,2022,12,S. Jean P. Port,351,52,403
3018,202212,2022,12,Sarria,1029,842,1871
3019,202212,2022,12,Tui,422,379,801
3020,202212,2022,12,Valença do Minho,141,238,379
3021,202212,2022,12,Vigo,79,209,288
